KEY	VALUE	COMMENTS
__id	jp
pedia.dialog.title	禁酒法百科事典
pedia.dialog.default-text	左のトピックを選択し、詳細をご覧ください。さらに詳しく知りたい方はリンクをたどって行くことも可能です
pedia.dialog.entry	<b><size=120%>{name}</size></b>\n\n{desc}
pedia.cat.resources	原材料
pedia.cat.businesses	ビジネスタイプ
pedia.cat.skills	技術
pedia.cat.gameplay	ゲームプレイ
pedia.cat.gambling	ギャンブル
pedia.cat.others	その他
info.resources.name	原材料
info.resources.desc	売買したり、生産・建設に使うもの。資源にはいくつかの種類があります。\n\n合法的な資源は、あなたがそれを知っている限り、誰からでも買うことができます。\n\n違法な資源は、特定の<link="businesses">企業</link>と売買する前に、<sprite name="ui pip social"> <link="relationships"> 信用レベル</link>が必要です。\n\n<sprite name="map resources HUD">原材料マップオーバーレイ</link> では、あなたの衣装が発見したリソースを販売している企業を見ることができます。\n\n<sprite name="ui skills"><link="skills">スキル</link> を習得し、<sprite name="ui tickets"><link="favors">恩義</link> を交換し、<sprite name="ui quests"><link="missions">ミッション</link> を達成すると、街にはたくさんの資源と機会が開放されることを待っていると分かるはずです。
info.fake-beer.icon	<sprite name="res fake-beer">
info.fake-beer.name	密造ビール
info.fake-beer.desc	"自家製ビールとホップの出会いで、よりお得な飲み物に！\n\n自家醸造ビールは、禁酒法が始まる前に大手ビールメーカーが作っていたものを、より高品質に再現したものです。この <link="refined-booze">精製酒</link> は <link="production-fake-beer">自家製ビール製造</link>で<link="hops">ホップ</link> と <link="home-brew">自家製ビール</link> を組み合わせ、それを <link="small-bottles">小さな瓶</link> にパッケージして喉が乾いたお客さんに出荷して作られるものです。適切な知識とアップグレードがあれば、<link="barley">大麦</link>とホップから直接、<link="production fake-beer-upgraded">自家製醸造</link>で作ることも可能です。\n\n<indent=15><b>基本価格\n<sprite name="ui sell"> 1ケースあたり$25</b></indent>\n\n<i><indent=30>ビールを飲む者はすぐに眠くなり、長く眠る者は罪を犯さず、罪を犯さない者は天国に入る。だから、ビールを飲もう。</indent></i>\n<indent=40>—マルティン・ルター</indent>"
info.fake-wine.icon	<sprite name="res fake-wine">
info.fake-wine.name	偽造ワイン
info.fake-wine.desc	"これは、魅力的な（より儲かる）ブリックワインである。\n\n<link="production-fake-wine">密造ワイン作業</link>では、<link="production-fake-wine">ブリックワイン</link>を樽から<link="bottle">ボトル</link>に移し、<link="labels">ラベル</link>を貼って、この<link="refined-booze">精製酒</link>を、フランスらしいおしゃれな名前を持つ何かとして売り込みます。  お客さんは偽物だとわかっていても、同じようにお金を払ってくれる。適切な技術と材料があれば、<link="production-fake-wine-upgraded">密造ワイナリー</link>で<link="grape">ブドウ</link>から直接作ることもできる。そして、そのブリックワインを別の場所で販売する。\n\n<indent=15><b>基礎価格\n<sprite name="ui sell"> １ケース$28 </b></indent>\n\n<i><indent=30>もっとワインをくれ さもないと放っといてくれ.</i></indent>\n<indent=40>—ルミ</indent>"
info.sparkling-cider.icon	<sprite name="res sparkling-cider">
info.sparkling-cider.name	スパークリングシードル
info.sparkling-cider.desc	"砂糖を使って、ハードシードルに余分な利益と発泡を入れることができる。\n\nスパークリングシードルは、通常の<link="cider">ハードシードル</link>に<link="sugar">砂糖</link>を加え、で<link="refined-booze">精製酒</link>である。 sparkling-cider">スパークリングシードル作業</link>， <link="small-bottles">小型瓶</link> に入れ、炭酸ガスが十分に発生し、シードルが発泡することを期待して待つのである。しかし、爆発するほど多すぎてもいけない。正しい知識があれば、<link="production-sparkling-cider-upgraded">スパークリングサイダー発酵器</link>で<link="apples">りんご</link>から直接スパークリングサイダーを作るようアップグレードすることが可能です。\n\n<indent=15><b>基礎価格\n<sprite name="ui sell"> １ケース$25 </b></indent>\n\n<i><indent=30>昨日のパン、今日の肉、そして去年のシードルをくれ。.</i></indent>\n<indent=40>—ベンジャミン・フランクリン</indent>"
info.bathtub-gin.icon	<sprite name="res bathtub-gin">
info.bathtub-gin.name	バスタブ・ジン
info.bathtub-gin.desc	"スパイスは、ムーンシャインをカクテルにふさわしいものに変えてくれる。\n\n<link="production-bathtub-gin">バスタブ・ジン製造</link>では、<link="moonshine">ムーン・シャイン</link>を<link="spices">スパイス</link>で醸造し、<link="small-bottle">小瓶</link>に入れて街中の酒場に運び、この酒を<link="refined-booze">精製酒</link>にする。また、<link="production-bathtub-gin-upgraded">バスタブ・ジン スチル</link> で <link="corn-syrup">コーンシロップ</link> から直接作る方法を学び、ムーンシャインを別の用途に使用することもできる。\n\n<indent=15><b>基礎価格\n<sprite name="ui sell">ケース $24</b></indent>\n\n<i><indent=30>私は自己管理を徹底しています。朝食前にジンより強い酒を飲むこaとはない。.</i></indent>\n<indent=40>—W.C.フィールズ</indent>"
info.moonshine.icon	<sprite name="res moonshine">
info.moonshine.name	ムーンシャイン
info.moonshine.desc	"樽に入れた中性アルコール、またはトウモロコシから作られた、強力なお酒。\n\n禁酒法により、誰もが蒸留酒に工夫を凝らすことを余儀なくされた。<link="moonshine">ムーンシャイン</link> は、<link="homebooze-moonshine">密造ムーンシャイン事業</link> で、<link="nute-alcohol">中性アルコール</link>中の不快（および毒）な添加物を蒸発させて作り、<link="clocks">壺</link> で少しだけ精製したお酒を販売する。\n\n<indent=15><b>基礎価格\n<sprite name="ui sell"> １壺$20</b></indent>\n\n<i><indent=30>禁酒法は酔いを戸外や暗い場所に追いやるだけで、治すことも減らすこともしない。</i></indent>\n<indent=40>—マーク・トウェイン</indent>"
info.brick-wine.icon	<sprite name="res brick-wine">
info.brick-wine.name	ブリックワイン
info.brick-wine.desc	"カリフォルニア産のブドウ濃縮物のブリックを使って、陶器の瓶にブリックワインを作る。\n\nカリフォルニアのブドウ園の所有者たちは、脱水された<link="grape-juice">ブドウ濃縮物</link>の均一なブリックを全国に送り出し、発酵を防ぐための非常に具体的な指示を添えていた。それが違法行為になるのだ。ただ、<link="crocks">陶器の瓶</link>にそれを入れ、水を混ぜるだけで、<link="homebooze-brick-wine">秘密のブリックワイン密造所</link>で作業ができ、その結果としてできた<link="homemade-booze">自家製酒</link>を販売できるだろう。\n\n<indent=15><b>\n基本価格 <sprite name="ui sell"> 1瓶あたり $15</b></indent>\n\n<i><indent=30>「ワインは最も健康的で、最も衛生的な飲み物である。」</i></indent>\n<indent=40>—ルイ・パスツール</indent>"
info.cider.icon	<sprite name="res cider">
info.cider.name	ハードシードル
info.cider.desc	"陶器の壺にリンゴジュースを入れておくだけで、すぐにハードシードルに変わります。\n\nシードル、特にアルコールを含むハードシードルは、アメリカで長い歴史を持つ<link="homemade-booze">自家製酒</link>の一種です。禁酒法時代には、ハードシードルの多くの家庭レシピや、忘れかけていたレシピが再び登場しました。<link="homebooze-cider">密造シードル事業</link>では、<link="apple-juice">リンゴジュース</link>を<link="crocks">陶器の壺</link>に入れ、発酵の魔法を待つだけです。\n\n<indent=15><b>基本価格\n<sprite name="ui sell"> 1壺あたり $12</b></indent>\n\n<i><indent=30>「昨日のパン、今日の肉、そして昨年のシードルをくれ。」</i></indent>\n<indent=40>—ベンジャミン・フランクリン</indent>"
info.home-brew.icon	<sprite name="res home-brew">
info.home-brew.name	自家製ビール
info.home-brew.desc	"今や乾いた醸造所から大量に生産される麦芽シロップは、簡単に自家製ビールへと変わる。\n\n1920年にアメリカ全土の醸造所が突然時代遅れになると、一部の醸造所は<link="malt">麦芽シロップ</link>の製造を始めた。そして、一般の人々が不幸にもそれが発酵してビールになってしまうのを避けるための注意深い指示を添えていた。<link="homebooze-home-brew">秘密の自家製ビール密造所</link>では、<link="crocks">陶器の瓶</link>と麦芽シロップを使って、大量の自家製ビールを生産している。\n\n<indent=15><b>\n基本価格 <sprite name="ui sell"> 1瓶あたり $8</b></indent>\n\n<i><indent=30>「ビールが醸されるところには、繁栄が訪れる。」</i></indent>\n<indent=40>—チェコのことわざ</indent>"
info.grape-juice.icon	<sprite name="res grape-juice">
info.grape-juice.name	ぶどう濃縮物
info.grape-juice.desc	"葡萄から作られ、決して発酵させてはいけない。\n\n1920年、ブドウ園のオーナーたちは厳しい決断を迫られた。ある者は他の植物を植えました。ある者は完全に廃業した。しかし、あるものは成長を続けた。彼らは収穫したブドウを出荷しやすいように濃縮したレンガに変えただけだった。ポートワインやシェリー酒などのフレーバーパックを同梱したものもあった。<link="conversion-grape-juice">ブドウ圧縮</link>で、<link="grapes">ブドウ</link>と<link="half-barrel">小型の樽</link>で作ることができます。</indent>\n\n<indent=15><b>基礎価格\n<sprite name="ui buy">小型の樽あたり$12 l</b></indent>\n\n<i><indent=30>1ガロンの水に溶かすと、1ガロンのノンアルコールパンチジュースができます。発酵を防ぐために、1-10%の安息香酸ソーダを加えてください。</i></indent>\n<indent=40>—Vino Sano カリフォルニア・グレープ・ブリックの説明書</indent>\n"
info.malt.icon	<sprite name="res malt">
info.malt.name	麦芽シロップ
info.malt.desc	"発芽した大麦から作られた濃厚なシロップで、発酵しやすい。\n\n1920年、醸造所は死活問題に直面した。ビールの製造が禁じられたため、いくつかの醸造所はアイスクリームやソーダの製造に切り替えた。しかし、一部の醸造所は当時の流行に乗り、麦芽シロップを飲むことで得られる独特の健康効果をアメリカ人に広めた ― もちろん、これを発酵させてビールのような飲み物にすることは<i>決して</i>しなかった。<link="conversion-malt">麦芽加工機</link>で<link="barley">大麦</link>から作ることができる。\n\n<indent=15><b>基本価格\n<sprite name="ui buy"> 小樽1本あたり $5</b></indent>\n\n<i><indent=30>脳が活力を奪い、食べ物が消化できず、食事から力を得られない時がある。この状態を放っておくと、病気の種をまいてしまうことになる。今すぐ行動せよ！ パブスト麦芽エキス - 「最高の」トニック。</i></indent>\n<indent=40>— パブスト麦芽トニック広告</indent>\n"
info.apple-juice.icon	<sprite name="res apple-juice">
info.apple-juice.name	りんごジュース
info.apple-juice.desc	りんごジュースは、ちょっとしたコツで簡単にハードシードルに変わる。\n\nかつて合衆国では、りんごを原料とするブランデーやハードシードルは最も一般的なアルコール飲料であった。ありふれたりんごを使って<link="cider">シードル</link>を作り販売することができる。<link="conversion-apple-juice">りんご圧搾機</link>に<link="apples">りんご</link>と<link="half-barrel">小さい樽</link>を供給することでりんごジュースを製造できる。\n\n<indent=15><b>基礎価格\n<sprite name="ui buy">1樽につき$8</b></indent>\n\n<i><indent=30>コネチカット州ニューヘブン郡の紳士は、最近、立派なリンゴ園の伐採を命じました。 「りんごはシードルに、シードルは蒸留酒になり、蒸留酒は飲めば人を酔わせるからだ」。</i></indent>\n<indent=40>ー1829年7月10日のフェニックス・ガゼット誌の禁酒運動に関する報告</indent>
info.neutral-alcohol.icon	<sprite name="res alcohol-btl">
info.neutral-alcohol.name	中性アルコール
info.neutral-alcohol.desc	"飲用に適さないが、業務用・工業用として使用できるアルコール。\n\nヴォルステッド法は、ウイスキーのような飲用を目的としたアルコールの製造を禁止する法律である。しかし、工業用エタノールは、あまりにも便利で、多くのものに必要なものであったため、禁止することができなかった。しかし、密造酒にしようと思えば、その状態を簡単に変換することができる。<link="corn-syrup">コーンシロップ</link> と <link="bottles">瓶</link> から、<link="conversion-neutral-alcohol">基礎的密造蒸留所</link> で作ることができる。\n\n<indent=15><b>基礎価格\n<sprite name="ui buy"> 1ケース$14</b></indent>\n\n<i><indent=30>非飲酒目的のアルコール.は、製造、購入、販売、交換、輸送、輸入、輸出、配送、供給、および所有することがでるが、ここに規定されている場合に限り、コミッショナーは申請により、許可を発行することができる。</i></indent>\n<indent=40>ボルステッド法（The Volstead Act， Title II， Sec 3）</indent>。"
info.crocks.icon	<sprite name="res jugs">
info.crocks.name	陶器瓶
info.crocks.desc	"基本的で一般的な容器で、自家製酒の製造に使われます。\n\n陶器の瓶はほぼすべての用途に使われました。安価で、大容量かつ持ち運びが容易です。\n\n<indent=15><b>基本価格\n <sprite name="ui buy"> 1つあたり $2</b></indent>\n\n<i><indent=30>「私は理想主義者だ。どこに向かっているのかはわからないが、進んでいるんだ。」</i></indent>\n<indent=40>—カール・サンドバーグ</indent>"
info.small-bottles.icon	<sprite name="res small-bottles">
info.small-bottles.name	小型瓶
info.small-bottles.desc	強い酒には小さな酒瓶を。\n\n小瓶は一部のアルコール飲料やその他の液体を瓶詰めするためのものだ。\n\n<indent=15><b>基礎価格\n<sprite name="ui buy">1ケースにつき$3</b></indent>\n\n<i><indent=30>私は夢に生きる。どこに行くのか分からないが、自分の道を進んでいる。</i></indent>\n<indent=40>ーカール・サンドバーグ</indent>
info.bottles.icon	<sprite name="res bottles">
info.bottles.name	瓶
info.bottles.desc	普通サイズのボトル。\n\nボトルはアルコール飲料やその他の液体の製造、輸送、貯蔵に使用される。\n\n<indent=15><b>基礎価格\n<sprite name="ui buy">1ケースにつき$5</b></indent>\n\n<i><indent=30>ドラムを叩け、バンジョーを叩け、サックスは長く涼しい風を切って吹いてくれ。全力でやれ、ジャズメン。</i></indent>\n<indent=40>ーカール・サンドバーグ</indent>
info.sugar.icon	<sprite name="res sugar">
info.sugar.name	砂糖
info.sugar.desc	サトウキビ（学名：Saccharum officinarum）\n\nイーストフード。砂糖は酵母の生成を促し、発泡させるのに有効である。\n\n<indent=15><b>基礎価格\n<sprite name="ui buy">1ケースにつき$6</b></indent>\n\n<i><indent=30>世界の豚肉屋、工具メーカー、小麦の積み出し屋、鉄道屋で貨物屋、嵐の様に荒れ狂い、がっしりとしていて、騒々しい、大きな肩の街シカゴ。</i></indent>\n<indent=40>—カール・サンドバーグ</indent>
info.hops.icon	<sprite name="res hops">
info.hops.name	ホップ
info.hops.desc	ホップ（学名：Humulus lupulus）\n\n酵母、大麦、水と共にビールを作る。ホップはビールに香りと風味を与え、よりビールらしさを引き出すために用いられる。\n\n<indent=15><b>基礎価格\n<sprite name="ui buy"> 1箱につき$25</b></indent>\n\n<i><indent=30>神様の恵み、ホップとモルト。</i></indent>\n<indent=40>ードイツの乾杯の挨拶</indent>
info.spices.icon	<sprite name="res spices">
info.spices.name	香辛料
info.spices.desc	酒に味わいを加える。\n\nスパイスを上手く使うことで、高級酒場のカクテルやドリンクに風味と個性を与えるさまざまなインフュージョンを作ることができる。\n\n<indent=15><b>基礎価格\n<sprite name="ui buy">1箱につき$15</b></indent>\n\n<i><indent=30><i>無節制な酒はいずれも邪悪なもので出来ており、呪われている</i></indent>\n<indent=40>—ウィリアム・シェイクスピア</indent>
info.labels.icon	<sprite name="res labels">
info.labels.name	ボトルラベル
info.labels.desc	酒瓶に「信用」という付加価値を貼り付ける。\n\nこの偽造ラベルは、瓶に貼ることで本物に見せかけるためのものだ。せっかく良い酒を作るのなら、このようなラベルで少しは気品を持たせても良いのではないだろうか。\n\n<indent=15><b>基礎価格\n<sprite name="ui buy">1箱につき$9</b></indent>\n\n<i><indent=30><i>ワインを入れると、不思議なものが出てくる。</i></indent>\n<indent=40>ーフリードリヒ・フォン・シラー</indent>
info.barley.icon	<sprite name="res barley">
info.barley.name	大麦
info.barley.desc	"Hordeum vulgare（オオムギ）\n\nビールや麦芽シロップの基礎となる大麦は、栄養価が高く、熟練した醸造家の手にかかればさらに多くの用途があります。\n\n<indent=15><b>基本価格\n<sprite name="ui buy"> 1箱あたり $9</b></indent>\n\n<i><indent=30>「深く根付いた嗜好は議論できない ― 人にビールを好きにさせることはできないのだ。」</i></indent>\n<indent=40>— オリバー・ウェンデル・ホームズ</indent>"
info.half-barrel.icon	<sprite name="res half-barrel">
info.half-barrel.name	小型樽
info.half-barrel.desc	"液体輸送用の小型の木樽。\n\nこの小さな樽は、ジュースや後の製造のための原料などを運ぶためのもの。\n\n<indent=15><b>基礎価格\n<sprite name="ui buy"> 各4ドル</b></indent>\n\n<i><indent=30><i>根強い嗜好は議論することができない。例えば、ビール一杯が好きな人を論破することはできない。</i></indent>\n<indent=40>—オリバー・ウェンデル・ホームズ</indent>"
info.corn-syrup.icon	<sprite name="res corn-syrup">
info.corn-syrup.name	コーンシロップ
info.corn-syrup.desc	糖分が多く蒸留しやすい。\n\nコーンシロップの工業生産の始まりは1920年代と比較的新しいが、発酵・蒸留が容易なため、中性アルコール製造の重要な原料となっている。\n\n<indent=15><b>基礎価格\n<sprite name="ui buy">1樽につき$4</b></indent>\n\n<i><indent=30>神よ、私を金床に置いてください。私を叩いて、バールのように叩いてください。古い壁をこじ開けさせてください 古い土台を持ち上げてゆるめさせてください。</i></indent>\n<indent=40>ーカール・サンドバーグ</indent>
info.grapes.icon	<sprite name="res grapes">
info.grapes.name	ブドウ
info.grapes.desc	ヨーロッパブドウ\n\nブドウの木の実。ブドウは数千年前から人類によって栽培され、主にワインの醸造に使われてきた。\n\n<indent=15><b>基礎価格\n<sprite name="ui buy"> 1箱$2</b></indent>\n\n<i><indent=30><i>未熟なブドウに憧れないでください。</i></indent>\n<indent=40>—ホラス</indent>
info.apples.icon	<sprite name="res apples">
info.apples.name	りんご
info.apples.desc	りんご（学名：Malus domestica）。\n\nりんごはヨーロッパの入植者たちとともに新大陸にやってきて盛んに作られた。アメリカ人はリンゴを使って多くのもの（特にアルコール飲料）を作った。\n\n<indent=15><b>基礎価格\n<sprite name="ui buy"> 1ブッシェルにつき$1</b></indent>\n\n<i><indent=30><i>確かにリンゴは果物の中で最も高貴なものだ。</i></indent>\n<indent=40>ーヘンリー・デイヴィッド・ソロー</indent>
info.citrus.icon	<sprite name="res citrus">
info.citrus.name	柑橘系果実
info.citrus.desc	さまざまな用途に使える魅力的な果物。\n\n柑橘類には色々な使い道がある。カクテルの味と見た目の両方を良くすることができる。また、オイルを含んだ果皮は、様々なインフュージョンやその他のアルコール製造に使用することができる。\n\n<indent=15><b>基礎価格\n<sprite name="ui buy">１かごにつき$2</b></indent>\n\n<i><indent=30><i>あなたはレモンの木が繁茂している土地を知っていますか、影のある葉の中に黄金のオレンジが輝いている土地を.....その場所へ、その場所へ、私はあなたと一緒に飛んで行きたいのです、愛する人よ！</i></indent>\n<indent=40>ーヨハン・ヴォルフガング・フォン・ゲーテ</indent>
info.fruit-other.icon	<sprite name="res fruit">
info.fruit-other.name	フルーツ
info.fruit-other.desc	糖分を多く含むものであれば発酵するはずである。\n\n市内の市場や卸売業者などでは、さまざまな種類の果物が1房単位で販売されている。このつつましいな漿果や核果の類は、適切な技術さえあれば、様々なアルコール飲料を蒸留したり、フルーツインフュージョンを作るのに利用することができる。\n\n<indent=15><b>基礎価格\n<sprite name="ui buy">1ブッシェルにつき$4</b></indent>\n\n<i><indent=30><i>秋の果樹園の真っ赤に熟した果実をください。</i></indent>\n<indent=40>ーウォルト・ホイットマン</indent>
info.wheat.icon	<sprite name="res wheat">
info.wheat.name	小麦
info.wheat.desc	"パンコムギ\n\n想像力の乏しい人は、小麦の実にパスタや小麦粉の未来を見るだけでしょう。しかし、ノウハウのある人は、何千年も人類とともにあるこの穀物が、<sprite name="res whiskey-barrel"> <link="whiskey-barrel">ウイスキー</link> やその他のおいしいお酒に変わる可能性を持っていることに気づいている。\n\n<indent=15><b>基礎価格\n<sprite name="ui buy"> １袋あたり$4</b></indent>\n\n<i><indent=30><i>一粒の小麦を理解できたら、不思議でたまらないでしょう。</i></indent>\n<indent=40>—マルティン・ルター</indent>"
info.rye.icon	<sprite name="res rye">
info.rye.name	ライ麦
info.rye.desc	ライ麦シリアル\n\n新石器時代から、人類はライ麦を栽培してきた。ドイツからロシア北部に広がるライ麦地帯の国々の料理には、この丈夫な穀物が多く使われている。また、ライ麦は麦芽化しやすく、ライ麦ビールやウイスキーなどの原料になりやすい。\n\n<indent=15><b>基礎価格\n<sprite name="ui buy"> １袋あたり$3</b></indent>\n\n<i><indent=30><i>農家は楽観主義者でなければ、まだ農家ではいられない。</i></indent>\n<indent=40>—ウィル・ロジャーズ</indent>
info.steel-barrels.icon	<sprite name="res steel-barrels">
info.steel-barrels.name	鋼鉄の樽
info.steel-barrels.desc	熱、圧力、またはその両方を必要とする用途に使用する。\n\n木製の樽はさまざまな用途に使われるが、熱に弱く、加圧された液体を入れることができない。一方、鋼鉄製の樽は、その点では優れている。\n\n<indent=15><b>基礎価格\n<sprite name="ui buy"> 一袋あたり$5</b></indent>\n\n<i><indent=30><i>神よ、私を金床（かなとこ）に置いてください。私を叩いて、バールのように叩いてください。古い壁をこじ開けさせてください 古い土台を持ち上げてゆるめさせてください。</i></indent>\n<indent=40>—カール・サンドバーグ</indent>
info.beer-keg.icon	<sprite name="res beer-keg">
info.beer-keg.name	ビール樽
info.beer-keg.desc	ビールをスチール製の樽に入れ、保管や輸送のスペースをより経済的に利用できるようにした。\n\n瓶ビールは収益性が高い反面、保管に大きなスペースが必要で、売場にも大きなスペースが必要だ。また、持ち運びも大変で、人目につきやすい。しかし、樽生ビールであれば、これらの問題が解決され、膨大な量の瓶が不要になる。このように、樽は酒造りにとってより良いソリューションなのだ。\n\n<indent=15><b>基礎価格\n<sprite name="ui sell"> １樽あたり$120</b></indent>\n\n<i><indent=30><i>私は、国民を強く信じています。真実が伝われば、どんな国家的危機にも対応できるはずです。大事なのは、本当の事実を伝えること、そしてビールだ。.</i></indent>\n<indent=40>—アブラハム。リンカーン</indent>
info.whiskey-bottled.icon	<sprite name="res whisky">
info.whiskey-bottled.name	瓶詰めウイスキー
info.whiskey-bottled.desc	"大麦やライ麦など、見た目と味を整えるために手元にあるもので作った濃いめのお酒。\n\nウィスキーの製造と飲用は、大西洋の両岸で長い歴史を持っている。当然のことながら、とても人気があるのだ。禁酒法以前はそうだった。その場しのぎのウイスキー醸造機でも、瓶で少量生産は可能だ。<sprite name="res whiskey-barrel"> <link="whiskey-barrel">ウイスキー樽</link> を手に入れれば、瓶詰め作業で瓶詰めのウィスキーを作ることができる。\n\n<indent=15><b>基礎価格\n<sprite name="ui sell"> １ケースあたり$45</b></indent>\n\n<i><indent=30><i>私は、このようなことをするのが好きではありません。あなたの社会的地位は、あなたの社会的地位と同じである。 そして、私は、あなたのことを、フェニックスと呼んでいます。</i></indent>\n<indent=40>—アイリッシュトースト</indent>"
info.brandy-bottled.icon	<sprite name="res brandy">
info.brandy-bottled.name	瓶詰めブランデー
info.brandy-bottled.desc	"果実を蒸留した強力なファイヤーウォーター。\n\nブランデーは、糖分の多い果物なら何でも作ることができるためほとんどの果物で作成可能だ。その場しのぎのブランデー・蒸留器を使って蒸留し、瓶に詰めて少量生産することができる。また、<sprite name="res brandy-barrel"> <link="brandy-barrel">ブランデー樽</link> を手に入れれば、瓶詰め作業で瓶詰めブランデーを作ることができる。\n\n<indent=15><b>基礎価格\n<sprite name="ui sell"> 1ケースあたり$30</b></indent>\n\n<i><indent=30><i>ブランデー（名詞）　雷と稲妻、自責の念、血まみれの殺人、死と地獄の墓場、サタンの4つの要素で構成されるコーディアル。</i></indent>"
info.vodka-bottled.icon	<sprite name="res vodka">
info.vodka-bottled.name	瓶詰めウォッカ
info.vodka-bottled.desc	"中央・東ヨーロッパからの移民とともに、ウォッカは誕生した。濾過と蒸留を繰り返すことで、心地よい火照りをもたらし、多くの素晴らしいカクテルのベースとなる。しかし、最悪の場合は、朝になればわかる。ウォッカの蒸留器を使えば、少量生産で瓶を作ることができる。また、<sprite name="res vodka-barrel"> <link="vodka-barrel">ウォッカ樽</link> を手に入れれば、瓶詰め作業で瓶詰めウォッカを作ることができる。\n\n<indent=15><b>基礎価格\n<sprite name="ui sell"> 1ケース$35</b></indent>\n\n<i><indent=30><i>ウォッカの飲み方を知っている人と、ウォッカが飲めなくても飲んでいる人がいる。前者は悲しみと喜びを喜びとし、後者は飲み方を知らずにウォッカを飲むすべての人のために苦しみます。.</i></indent>\n<indent=40>—Isaac Babel</indent>"
info.rum-bottled.icon	<sprite name="res rum">
info.rum-bottled.name	瓶詰めラム酒
info.rum-bottled.desc	"糖蜜など砂糖の副産物から作られるラム酒は、非常に人気がある。\n\n新大陸での砂糖の生産は、もともとラム酒という一つの目的のために行われていた。このスパイシーな飲み物は、現在では多くのヒップなカクテルやドリンクのバックボーンを形成している。その場しのぎのラム蒸留器で、瓶に詰めたラム酒を少量生産することができる。また、<sprite name="res barrel-rum"> <link="rum-barrel">ラム樽</link> を手に入れれば、瓶詰め作業で瓶詰めのラム酒を作ることができる。\n\n<indent=15><b>基礎価格\n<sprite name="ui sell"> 1ケース$28</b></indent>\n\n<i><indent=30><i>ラム酒と真の宗教ほど、精神を落ち着かせるものはないだろう。</i></indent>\n<indent=40>—Lord Byron</indent>"
info.whiskey-barrel.icon	<sprite name="res whiskey-barrel">
info.whiskey-barrel.name	ウイスキー樽
info.whiskey-barrel.desc	"穀物からウイスキースチルにて製造。\n\n十分な規模と技術力があれば、<sprite name="res wheat"> <link="wheat">小麦</link> や <sprite name="res rye"> <link="rye">ライ麦</link> から大量のウイスキー樽に変換できる大型の蒸留器を建設できるようになる。これらは他の進取の気性に富んだ密造者に直接売ったり、瓶詰め作業に運んで<sprite name="res bottles"> <link="bottles">瓶</link> に入れ、<sprite name="res labels"> <link="labels">ラベル</link> を貼り付けて、<sprite name="res whisky"> <link="whiskey-bottled">瓶詰めウイスキー</link> として喉の乾いた客に販売できるのである。\n\n<indent=15><b>基礎価格\n<sprite name="ui sell"> １樽あたり2	000ドル</b></indent>\n\n<i><indent=30>蛇に噛まれた時のために、常にウイスキーの樽を携帯し、さらに小さな蛇を常に携帯している。</i></indent>\n<indent=40>—W.C. Fields</indent>"
info.brandy-barrel.icon	<sprite name="res brandy-barrel">
info.brandy-barrel.name	ブランデー樽
info.brandy-barrel.desc	"果実からブランデースチルで製造。\n\n十分な規模と技術力があれば、<sprite name="res fruit"> <link="fruit-other">果物</link> をブランデーの大樽に変換する大型ブランデースチルを建設することができるようになる。これらは他の進取の気性に富んだ密造者に直接販売することもできるが、瓶詰め作業場に運んで、<sprite name="res bottles"><link="bottles">瓶</link> に入れ、<sprite name="res labels"> <link="labels">ラベル</link> を貼り付けて、<sprite name="res brandy"> <link="brandy-bottled">-瓶詰めブランデー</link> を喉が乾いた客に販売することができる。<link="fruit-other">\n\n<indent=15><b>基礎価格\n<sprite name="ui sell"> １樽あたり$1	200</b></indent>\n\n<i><indent=30>クラレットは少年のための酒、ポートワインは男のための酒、しかし英雄になろうとする者はブランデーを飲まねばならない。\n<indent=40>-サミュエル・ジョンソン</indent>。"
info.vodka-barrel.icon	<sprite name="res vodka-barrel">
info.vodka-barrel.name	ウォッカ樽
info.vodka-barrel.desc	"大麦を原料にウォッカ蒸留器で製造。\n\n十分な規模と技術力があれば、ウォッカの大型蒸留器を建設し、<sprite name="res barley"><link="barley"> 大麦</link>をウォッカを大樽サイズで製造することができます。これを他の酒造業者に直接売ったり、瓶詰め工場に運んで<sprite name="res bottles"><link="bottles">ボトル</link> に入れ、<sprite name="res labels"><link="labels">ラベル</link> を貼り付けて、喉が渇いた客に<sprite name="res vodka"> <link="vodka-bottled">瓶詰めウォッカ</link> として販売したりすることができる。\n\n<indent=15><b>基礎価格\n<sprite name="ui sell">1バレルあたり$1，000</b></indent>\n\n<i><indent=30>愛に溺れたいのか、ウォッカに溺れたいのか、海に溺れたいのか、もうわからない。</i></indent>\n<indent=40>—フランツ・カフカ</indent>"
info.rum-barrel.icon	<sprite name="res barrel-rum">
info.rum-barrel.name	ラム樽
info.rum-barrel.desc	"砂糖を原料にラム酒蒸留器で製造できる。\n\n十分な規模と技術力があれば、大型のラム酒蒸留器を建設し、<sprite name="res sugar"> <link="sugar">砂糖</link> を原料に大量のラム酒樽を製造できるようになります。このラム酒は他の密造業者に直接売ったり、瓶詰め工場に運んで<sprite name="res bottles"><link="bottles">ボトル</link> に入れ、<sprite name="res labels"><link="labels">ラベル</link> を貼り、<sprite name="res rum"> <link="rum-bottled">瓶詰めラム酒</link> として喉が渇いたお客さんに販売できます。\n\n<indent=15><b>基礎価格\n<sprite name="ui sell">1バレルあたり $800</b></indent>\n\n<i><indent=30>その音には、ラムを連想させる響きがあった。</i></indent>\n<indent=40>—ロバート・ルイス・スティーブンソン</indent>"
info.cigarettes.icon	<sprite name="res cigarettes">
info.cigarettes.name	巻きたばこ
info.cigarettes.desc	"密輸タバコは、地元のビジネスオーナーに取り入る良いきっかけになります。\n\nタバコにかかる税金が高いので、わざわざ南部の工場から町に密輸するには魅力的なアイテムです。\n地元のフーリガンが友人の繋がりから調達することもあれば、トラックや鉄道車両に積まれているのを「偶然見つける」こともある。どのようなきっかけであれ、それを使って経営者と<sprite name="ui pip social"> <link="relationships"> 信頼</link>を築き、<sprite name="ui tickets"> <link="favors"> 1つや2つの好意</link>を獲得することができるのです。\n\n<i><indent=30><i>タバコは完全な快楽の完全なタイプである。それは絶妙で人を満足させることはない。これ以上何を望む？\n<indent=40>—オスカル・ワイルド</indent>。"
info.corn.icon	<sprite name="res corn">
info.corn.name	コーン
info.corn.desc	<b>一部の都市でのみ利用可能な事業</b>\n\n正しい知識を持っていれば、トウモロコシは<sprite name="res moonshine"><link="moonshine">ムーンシャイン</link>、<sprite name="res corn whiskey"><link="corn-whiskey">コーンウイスキー</link>、<sprite name="res bourbon"><link="bourbon">バーボン</link>など、様々な強力な酒に変えることができます。\n\n<i><indent=30><i>穀物がないところには、それは都市に向けられた復讐のしるしです。</i></indent>\n<indent=40>—古代シュメールのことわざ</indent>
info.corn-whiskey.icon	<sprite name="res corn whiskey">
info.corn-whiskey.name	コーンウイスキー
info.corn-whiskey.desc	<b>地域の製品はすべての都市で利用可能ではありません。</b>\n\n<sprite name="res corn"> <link="corn">コーン</link>は非常に高い糖分を含んでいます。糖分が高いものは発酵しやすく、一度発酵すると、アルコールに蒸留されます。実際、アメリカ人はコーンを栽培し、コーンからウイスキーを蒸留してきました。もしあなたの街がコーンの供給源、例えば地元の畜産市場から入手できるなら、この新しい酒を作成することが可能です。\n\n<indent=15><b>基本価格\n<sprite name="ui sell"> 1ケースあたり$26</b></indent>\n\n<i><indent=30><i>彼らは罰を受けずに飲む、または彼らを招待する人と一緒に。</i></indent>\n<indent=40>—アーテマス・ワード</indent>
info.bourbon.icon	<sprite name="res bourbon">
info.bourbon.name	バーボン
info.bourbon.desc	"<b>地域限定商品ですべての都市で入手できるわけではありません。</b>\n\nケンタッキー州 - 「ブルーグラス州」 - は美しい馬の牧場、1875年から続く有名な競馬、そしてバーボンで知られています。禁酒法時代、6つの会社が「医療用ウィスキー」を販売するための許可を申請しました。そのうち4つはケンタッキー州にありました。実際、禁酒法前のアメリカのウィスキー生産の80％は、オハイオ川を越えたシンシナティから数百マイル以内の範囲に集中していました。もしあなたがケンタッキー出身の人と仲良くなれたら、彼らは<sprite name="res corn"> <link="corn">トウモロコシ</link>、<sprite name="res oak-barrels"> <link="oak-barrels">オーク樽</link>、そして少しの<sprite name="res food-dye"> <link="food-dyes">食品用染料</link>を使ってその作り方を教えてくれるかもしれません。\n\n<indent=15><b>基本価格\n<sprite name="ui sell"> 1ケース $64</b></indent>\n\n<i><indent=30>「私の人生で、銃とトランプ、そしてウィスキーの壺を持っていないケンタッキー出身者を見たことがない。」</i></indent>\n<indent=40>—アンドリュー・ジャクソン</indent>"
info.english-gin.icon	<sprite name="res english-gin">
info.english-gin.name	イングリッシュ・ジン
info.english-gin.desc	"<b>地域限定商品ですべての都市で入手できるわけではありません。</b>\n\nクリーンでシャープ、そしてジュニパーベリーの風味を持つこのイギリスからの輸入品は、かつてロンドンの「ジン狂騒」の時代にはビールよりも1パイントあたり安価で手に入ったほど普及していました。今では、地元で作れるものとそれほど違いはありませんが、その物語だけでも高級サパークラブやホテルが高額で買い求める人気の輸入品です。\n\nイギリス人はロンドン・ドライやプリマススタイルのジンなど、ジンを有名にするさまざまな特長を持っているため、これを密輸して地元の忠実な顧客に売り込むなら、イギリス人の協力を得る必要があるでしょう。\n\n<indent=10><b>基本価格\n<sprite name="ui sell"> 1ケース $90</b></indent>\n\n<indent=20><i>「人生は金箔をかぶせなければ誰も飲み込めない丸薬だ。」</i></indent>\n<indent=40>—サミュエル・ジョンソン</indent>"
info.scotch-whiskey.icon	<sprite name="res scotch-whiskey">
info.scotch-whiskey.name	スコッチウイスキー
info.scotch-whiskey.desc	"<b>地域限定商品ですべての都市で入手できるわけではありません。</b>\n\nスコットランドで蒸留され、オーク樽で最低3年間熟成された本物のスコッチは、種類が豊富でありながらも非常に貴重です。もちろん、地元でも似たようなものは作れますが、世代を超えた経験が詰まったスコットランド産の輸入品は、より古く、洗練され、金を出してでも手に入れたい富裕層の間で話題になる代物です。\n\nスコッチ蒸留業者は、厳しい規制に何世代にもわたって対抗し、税務署員の目を逃れるために密かに作業を続けてきました。いずれにせよ、この由緒ある酒をアメリカに輸入して販売するには、地元のスコットランド人の助けが必要でしょう。\n\n<indent=10><b>基本価格\n<sprite name="ui sell"> 1ケース $110</b></indent>\n\n<indent=20><i>「尊敬すべきウィンストン・S・チャーチル氏は、特に食事時にアルコールの摂取を必要とする。」</i></indent>\n<indent=40>—オットー・C・ピッカート（1932年、アメリカの医師のメモより）</indent>"
info.irish-whiskey.icon	<sprite name="res irish-whiskey">
info.irish-whiskey.name	アイリッシュウイスキー
info.irish-whiskey.desc	"<b>地域限定商品ですべての都市で入手できるわけではありません。</b>\n\nこの人気のあるスピリッツの味は禁酒法以前から多くの人々に親しまれており、その懐かしさを満たすために大金を払う人もいるでしょう。世界最古のウィスキー伝統を誇るこのアイルランド産のボトルは、手に入れれば非常に人気のある商品です。幸いにも、多くのアイルランド蒸留業者が禁酒法以前の最大の市場に再びアクセスできることを望んでいます。\n\nアイルランド産ウィスキーを入手するには、地元のアイルランド人の助けを借りて、故郷の蒸留所と連絡を取る必要がありますが、一度手に入れれば、地元のビジネスや高級ホテル、レストランの間で多くの買い手が見つかるでしょう。\n\n<indent=10><b>基本価格\n<sprite name="ui sell"> 1ケース $100</b></indent>\n\n<indent=20><i>uisce beatha</i></indent>\n<indent=40>ウィスキーの原語であるアイルランド語。意味は「生命の水」</indent>"
info.german-schnapps.icon	<sprite name="res german-schnapps">
info.german-schnapps.name	ジャーマン・シュナップス
info.german-schnapps.desc	"<b>地域限定商品ですべての都市で入手できるわけではありません。</b>\n\nクリアでフルーティー、そしてアルコール度数が高いこのリキュールは、発酵した果物やハーブの抽出物からドイツで作られています。果物シロップと低アルコールで簡単に模倣品のシュナップスを作ることはできますが、本物のドイツ産の風味に勝るものはなく、高級顧客はその違いを味わうためにお金を払います。\n\nシュナップスの風味は蒸留に使用される果物によって異なりますが、ヨーロッパでは氷の上にストレートで飲むのが一般的で、寒い冬の日にはウォームアップショットとして飲まれることもあります。どのように飲むにせよ、この飲み物を輸入し、渇いたホテルやサパークラブに販売するには、地元のドイツ人の助けが必要でしょう。\n\n<indent=10><b>基本価格\n<sprite name="ui sell"> 1ケース $95</b></indent>\n\n<indent=20><i>「どんな症状でも、シュナップスの小さなグラス一杯でたちどころに治るものだ。」</i></indent>\n<indent=40>—モリー・ピコン</indent>"
info.caribbean-rum.icon	<sprite name="res carribean-rum">
info.caribbean-rum.name	カリビアン・ラム
info.caribbean-rum.desc	"<b>地域限定商品ですべての都市で入手できるわけではありません。</b>\n\n糖蜜（砂糖の製造過程で生じる副産物）から作られるラム酒は、ドライで甘く、濃厚な味わいを持ち、さまざまなカクテルに使ったり、ストレートで楽しむことができます。禁酒法時代には、その希少性から価格が高騰し、安定した供給源を手に入れることができれば、大きな利益を約束します。\n\nラム酒をアメリカ本土の渇いた顧客に販売するには、島々からアメリカの海岸に密かに持ち込む方法を見つける必要があります。島の現地の協力者の助けを得れば、地元のホテルや飲食店に高値で売ることができるでしょう。\n\n<indent=10><b>基本価格\n<sprite name="ui sell"> 1ケース $90</b></indent>\n\n<indent=20><i>「モラセス（糖蜜）がアメリカの独立に不可欠な要素だったと告白することを恥じる必要はないだろう。多くの大事件は、もっと小さな原因から生じているのだから。」</i></indent>\n<indent=40>—ジョン・アダムズ</indent>"
info.ice.icon	<sprite name="res ice">
info.ice.name	氷
info.ice.desc	"氷は冷却に使われ、多くの工業用途があります。\n\n20世紀初頭には冷却の革命が起こりました。つい最近までは、大量の氷を手に入れる唯一の方法は、凍った湖や川から氷を採取し、地下に保存することでした。この方法は比較的高価で管理が難しいものでした。しかし、電気冷蔵技術の発展により、工場で大量に氷を生産できるようになりました。氷は多くの高級酒の製造や、<sprite name="res apple-jack">アップルジャック</sprite>の製造にも役立ちます。特定のビジネスから購入することができ、より安定した供給が必要であれば、独自のアイスハウスを設置することもできます。\n\n<indent=15><b>基本価格\n<sprite name="ui buy"> 1トレイ $2</b></indent>\n\n<i><indent=30>「文明は蒸留から始まる。」</i></indent>\n<indent=40>—ウィリアム・フォークナー</indent>"
info.applejack.icon	<sprite name="res apple-jack">
info.applejack.name	アップルジャック
info.applejack.desc	"<b>地域限定商品ですべての都市で入手できるわけではありません。</b>\n\n発酵は、穀物、果物、野菜の糖分からアルコールを生み出す魔法です。通常、ワインやビールのように発酵した液体をそのまま飲んだり、ウィスキーやラムなどの蒸留酒にしたりしますが、もう一つのアルコールの取り出し方があります。それが「ジャッキング」です。この場合、<sprite name="res apple-juice"> <link="apple-juice">リンゴジュース</link></sprite>が発酵した後、それを何度も凍らせて水分を取り除き、そのたびにアルコール度数が高まる飲み物、アップルジャックが完成します。\n\n<indent=15><b>基本価格\n<sprite name="ui sell"> 1瓶あたり $20</b></indent>\n\n<i><indent=30>「霜がその秘密の役割を果たす。風の助けを借りることなく。」</i></indent>\n<indent=40>—サミュエル・テイラー・コールリッジ</indent>"
info.plums.icon	<sprite name="res plums">
info.plums.name	プラム
info.plums.desc	"<b>地域限定商品ですべての都市で入手できるわけではありません。</b>\n\nプラムには多くの品種があり、そのほとんどが優れたブランデーの原料となります。スリヴォヴィッツや他の名称で呼ばれることもありますが、南ヨーロッパでは<sprite name="res rakija"> <link="rakija">ラキヤ</link></sprite>として知られており、そのレシピはアメリカ大陸への移民とともに伝えられました。\n\n<indent=15><b>基本価格\n<sprite name="ui buy"> 1ブッシェルあたり $6</b></indent>\n\n<i><indent=30>「それぞれの木には、美しい果実が実り、目を引き、誘惑し、私の中に突然、摘んで食べたいという欲望をかき立てた。」</i></indent>\n<indent=40>—ジョン・ミルトン</indent>"
info.rakija.icon	<sprite name="res rakija">
info.rakija.name	ラキヤ
info.rakija.desc	"<b>地域限定商品ですべての都市で入手できるわけではありません。</b>\n\n<sprite name="res plums"> <link="plums">プラム</link>が豊富に手に入る時と場所では、ラキヤ作りを始める時です。南ヨーロッパからの移民によってアメリカにもたらされたこの強力な酒は、元々の民族コミュニティを超えてその魅力を広げてきました。この酒が知られている都市では、簡単に蒸留して流通させることができます。\n\n<indent=15><b>基本価格\n<sprite name="ui sell"> 1ケース $30</b></indent>\n\n<i><indent=30>「子供、愚か者、そして酔っ払いは真実を語る。」</i></indent>\n<indent=40>—クロアチアのことわざ</indent>\n"
info.champagne.icon	<sprite name="res champagne">
info.champagne.name	シャンパン
info.champagne.desc	この泡立つ高級ワインは街の高級レストランやホテルにおいて高値で取引される。\n\nシャンパンのコルクが弾け、泡立つワインが噴き出す様は、古くから祝宴の始まりの合図とされてきた。禁酒法下の暗黒の時代の中でも、人生の喜びの瞬間を記憶に刻むためにそのような場面はよくあるのだが、今やシャンパンは法的には禁じられたものという扱いになっている。密輸業者を介するか、適切な設備を用意して製造することによって入手することが可能である。\n\n<indent=15><b>基礎価格\n<sprite name="ui sell"> 1ケースにつき$50</b></indent>\n<i><indent=30><i>私はビール一筋なんでね。シャンパンなんて邪道だよ。</i></indent>\n<indent=40>ージョージ・バーナード・ショー</indent>\n
info.cordials.icon	<sprite name="res cordials">
info.cordials.name	コーディアル
info.cordials.desc	コーディアルは食後にちびりちびりとやったり、カクテルに加えたりすることで、さらに洗練された味わいを楽しむことができる。この高級酒は街の高級レストランやホテルで高値で取引される。\nコーディアルは、秘伝のレシピと伝統的な国民的味覚の領域であり、通常、ある種のアルコールにさまざまなハーブやアロマを煎じることで作られる。密輸業者を介するか、適切な技術を習得して密造することで入手することが可能である。\n\n<indent=15><b>基礎価格\n<sprite name="ui sell">1ケースにつき$70</b></indent>\n<i><indent=30><i>マティーニはソネットのように完璧なアメリカ唯一の発明品だ。</i></indent>\n<indent=40>—ヘンリー・ルイス・メンケン</indent>
info.dark-rum.icon	<sprite name="res dark rum">
info.dark-rum.name	スパイス入りラム酒
info.dark-rum.desc	暗く甘美なスパイスラムは、カクテルに深い味わいと複雑な風味を与える。高級レストランやホテルはこの火酒を高値で買ってくれる。\n植民地時代から続く伝統で、ダークスパイスラムは常に高い人気を誇っている。 スパイスの効いたラム酒なしには、どんな素晴らしいパンチボウルも完成しない。スパイスラムは密輸業者を介するか、適切なスキルを習得して密造することで入手することができる。\n\n<indent=15><b>基礎価格\n<sprite name="ui sell"> 1ケースにつき$85</b></indent>\n<i><indent=30><i>ワインには知恵があり、ビールには自由があり、水には細菌がある。</i></indent>\n<indent=40>ーベンジャミン・フランクリン</indent>\n\n
info.aged-whiskey.icon	<sprite name="res aged whiskey">
info.aged-whiskey.name	熟成ウイスキー
info.aged-whiskey.desc	オーク材の香りと熟成による複雑な味わいが特徴のウイスキーであり、飲食店やクラブ、ホテルなどで高値で取引されている。\nオーク樽でウイスキーを熟成させると、アルコールと木の相互作用で複雑な風味が生まれる。味わいが柔らかくなり、香りが漂い、余韻が残る、まさに高貴な飲み物である。密輸業者を介するか適切なスキルを習得して密造することで入手することが可能である。\n\n<indent=15><b>基礎価格\n<sprite name="ui sell"> 1ケースにつき$90</b></indent>\n\n<i><indent=30><i>何事もやり過ぎはよくないが、良いウイスキーはやり過ぎるほどは無いんだ。</i></indent>\n<indent=40>ーマーク・トウェイン</indent>\n
info.gin.icon	<sprite name="res gin">
info.gin.name	ジン
info.gin.desc	"カクテルに欠かせない重要な材料。高級店は「良いもの」を手に入れるために高額を支払うでしょう。\n\nトニックウォーターと組み合わせたり、マティーニにシェイクしたり、ギムレットにかき混ぜたり、この普遍的な蒸留酒はカクテルメニューの主力です。複雑でエキゾチックな香料やスパイスから作られ、飲み物に満足感のある複雑さを与えます。\n\n<indent=15><b>基本価格\n<sprite name="ui sell"> 1ケース $70</b></indent>\n\n<i><indent=30>「芸術のための芸術は、ジンのためのジンと同じくらい無意味だ。」</i></indent>\n<indent=40>—W・サマセット・モーム</indent>"
info.oak-barrels.icon	<sprite name="res oak-barrels">
info.oak-barrels.name	オーク樽
info.oak-barrels.desc	"これらの特製樽は、ウィスキー、ラム酒、そして一部のブランデーの長期熟成に使用されます。この過程では、複雑な化学反応が奇跡的な変化を引き起こし、荒々しいアルコールが、ゆっくりと満足感のある一口にふさわしい飲み物に変わります。オーク樽は、<sprite name="res aged whiskey"> <link="aged-whiskey">熟成ウィスキー</link>、<sprite name="res dark rum"> <link="dark-rum">スパイスラム</link>、一部の<link="gin">ジン</link>、および<link="bourbon">バーボン</link>の製造に必要です。\n\n<indent=15><b>基本価格\n<sprite name="ui buy"> 1樽あたり $18</b></indent>\n\n<i><indent=30>「時間は人生において最も貴重な貨幣だ。それをどう使うかは自分次第。他人にそれを使わせないように注意しなければならない。」</i></indent>\n<indent=40>—カール・サンドバーグ</indent>"
info.food-dyes.icon	<sprite name="res food-dye">
info.food-dyes.name	食品用着色料
info.food-dyes.desc	"多くの種類のウィスキー、熟成ブランデー、スパイスラムの深いキャラメル色は、長期熟成と秘密のレシピによる複雑な化学反応から生まれます。あるいは、自分なりの化学を使い、工業用の食品用着色料を加えるだけでも同じ効果が得られます。これらの食品用染料は、酒類の偽造者にとって大きな助けとなり、偽酒を高級価格で販売しようとする際に非常に役立ちます。\n\n<indent=15><b>基本価格\n<sprite name="ui buy"> 1箱あたり $15</b></indent>\n\n<i><indent=30>「錬金術を化学と混同するのは誤りだ。」</i></indent>\n<indent=40>—フランツ・ハルトマン</indent>"
info.pipes.icon	<sprite name="res pipes">
info.pipes.name	パイプ
info.pipes.desc	"<b>多くの作業場の建設に必要な建材です。</b>\n\n通常は水を都市内や家庭、ビジネス、工場に供給するために使われますが、液体を大量に移動させる必要がある他の用途にもパイプが必要です。\n\n<indent=15><b>基本価格\n<sprite name="ui buy"> 1箱あたり $30</b></indent>"
info.lumber.icon	<sprite name="res lumber">
info.lumber.name	木材
info.lumber.desc	"<b>多くの作業場の建設に必要な建材です。</b>\n\n板材や林業関連製品は、私たちがシンプルな構造物を建て始めて以来、建設の基盤となってきました。これは、安価で軽量、かつ入手しやすい材料で、内装および外装の改良に最適です。\n\n<indent=15><b>基本価格\n<sprite name="ui buy"> 1箱あたり $30</b></indent>"
info.bricks.icon	<sprite name="res bricks">
info.bricks.name	レンガ
info.bricks.desc	"<b>多くの作業場の建設に必要な建材です。</b>\n\n焼きレンガは、20世紀初頭のアメリカの都市拡大の文字通りの基盤でした。レンガは、多くの種類の酒類生産のしっかりとした基盤を築くのにも役立ちます。\n\n<indent=15><b>基本価格\n<sprite name="ui buy"> 1箱あたり $35</b></indent>"
info.sheet-metal.icon	<sprite name="res sheet metal">
info.sheet-metal.name	板金
info.sheet-metal.desc	"<b>多くの作業場の建設に必要な建材です。</b>\n\n薄く、軽く、そして強度があるこれらの金属シートは、酒類生産の作業場を建設する際に非常に役立ちます。特に蒸留器や大規模施設の建設に適しています。\n\n<indent=15><b>基本価格\n<sprite name="ui buy"> 1箱あたり $35</b></indent>"
info.furniture.icon	<sprite name="res furniture">
info.furniture.name	家具
info.furniture.desc	"<b>多くの作業場の建設に必要な建材です。</b>\n\nシンプルな密造酒の作業場は、簡単なカウンターや裏部屋からでも運営できます。しかし、より複雑で収益性の高いスピークイージーや酒場を建設するには、バー、テーブル、椅子、その他必要な備品を揃える必要があります。\n\n<indent=15><b>基本価格\n<sprite name="ui buy"> 1箱あたり $25</b></indent>"
info.canadian-whiskey.icon	<sprite name="res canadian whiskey">
info.canadian-whiskey.name	カナディアンウイスキー
info.canadian-whiskey.desc	<b>地域限定商品は、すべての都市で販売されているわけではありません</b>\n\nカナディアンウイスキーは、そのまま飲んでも、上質なカクテルの材料としても、多くの人に愛飲されている酒である。\n\n禁酒法時代、アメリカの蒸留所は軒並み操業を停止したが、国境の北側（デトロイトでは南側）の生産者は操業を続け、カナダの穀物の実から垂涎の逸品を作り出した。\n\n<indent=15><b>基礎価格\n<sprite name="ui sell"> ケースあたり$60</b></indent>\n\n<indent=30><i>カナダの冬を乗り切るには、真鍮の体、ガラスの目、そしてブランデーの血が必要です。</i></indent>\n<indent=40>-ルイ・アルマン・ド・ロム・ダルセ・ラホンタン</indent>
info.fruit-wine.icon	<sprite name="res fruit-wine">
info.fruit-wine.name	フルーツワイン
info.fruit-wine.desc	"<b>地域限定商品ですべての都市で入手できるわけではありません。</b>\n\nブドウ以外の多くの<link="fruit-other">果物</link>も、少量の<link="sugar">砂糖</link>を加えることで、簡単に発酵してワインになります。\n\n果樹園が多く存在し、ブドウには適さない地域（例えばミシガン州など）では、さまざまな種類の果物からワインを作ることができます。\n\n<indent=15><b>基本価格\n<sprite name="ui sell"> 1ケース $18</b></indent>\n\n<indent=30><i>「美しい半島を探すなら、周りを見渡せ。」</i></indent>\n<indent=40>—ミシガン州の標語</indent>"
info.gasoline.icon	<sprite name="res gasoline">
info.gasoline.name	ガソリン
info.gasoline.desc	"便利な燃料。機械の燃料として使用でき、場合によっては溶剤としても利用されます。\n\n<indent=15><b>基本価格\n<sprite name="ui buy"> 1樽あたり $8</b></indent>\n\n<indent=30><i>「特許カゼリンオイルは、安全で、経済的かつ輝かしいものであり、長い間求められてきた強力な人工光の手段としてすべての要件を満たしています。」</i></indent>\n<indent=40>—ジョン・カッセル</indent>"
info.barrels.icon	<sprite name="res barrels">
info.barrels.name	樽
info.barrels.desc	"大きな木製の樽は、液体の輸送、保管、または<i>発酵</i>に最適です。\n\nいくつかの作業場の建設やアルコール製造に使用されます。\n\n<indent=10><b>基本価格\n<sprite name="ui buy"> 1つあたり $3</b></indent>\n\n<i><indent=30>「深く根ざした嗜好について議論はできない。ビールを好きになるように人を説得することはできない。」</i></indent>\n<indent=40>—オリヴァー・ウェンデル・ホームズ</indent>"
info.paper.icon	<sprite name="res paper">
info.paper.name	紙
info.paper.desc	"工業用の紙のシートは、簡単に偽造ラベルに変えられ、さまざまな酒類生産を格上げすることができます。\n\nラベルの製造に使用されます。\n\n<indent=10><b>基本価格\n<sprite name="ui buy"> 1束あたり $10</b></indent>\n\n<i><indent=30>「ワインが入ると、奇妙なことが起こる。」</i></indent>\n<indent=40>—ヨハン・シラー</indent>"
info.weapon-bat.icon	<sprite name="ui weapon bat">
info.weapon-bat.name	野球のバット
info.weapon-bat.desc	"スポーツで使用される厚い木製のバットですが、都合よくもう一つの用途があります。それは、あなたに手を出すべきではないと敵に思い出させることです。合法的に持ち歩けますが、やや粗野な印象があることは否めません。この野球バットは、下級ギャングにとって便利な武器です。\n\n低ダメージ: 10 — 高ダメージ: 30\n\n<indent=10><b>基本価格\n<sprite name="ui buy"> 1本あたり $5</b></indent>"
info.weapon-billy-club.icon	<sprite name="ui weapon bat">
info.weapon-billy-club.name	警棒
info.weapon-billy-club.desc	"野球バットのようですが、少しだけその意図が正直です。適切な手に握られれば、さらに強く振り回し、より凶悪な一撃を繰り出しますが、買収していない警官に対して弁解するのは少々難しいかもしれません。\n\n低ダメージ: 20 — 高ダメージ: 50\n\n<indent=10><b>基本価格\n<sprite name="ui buy"> 1本あたり $20</b></indent>"
info.weapon-crowbar.icon	<sprite name="ui weapon crowbar">
info.weapon-crowbar.name	バール
info.weapon-crowbar.desc	"建設や解体作業、そして誠実な人々から彼らの苦労して稼いだ物を奪う際に役立つ道具です。合法的に持ち歩けますが、必要であれば頭を叩きつけるための素晴らしい鈍器としても使えます。\n\n低ダメージ: 20 — 高ダメージ: 40\n\n<indent=10><b>基本価格\n<sprite name="ui buy"> 1束あたり $10</b></indent>"
info.weapon-colt.icon	<sprite name="ui weapon pistol">
info.weapon-colt.name	コルトリボルバー
info.weapon-colt.desc	"もっと大きくてかさばる武器にアップグレードしなくても、これほど強力で大きな音を立てるリボルバーがあれば、組織内のどんな力でも瞬時に脅威となるでしょう。近接武器ほど静かでも手軽でもありませんが、より高い威力を発揮します。\n\n低ダメージ: 40 — 高ダメージ: 60\n\n<indent=10><b>基本価格\n<sprite name="ui buy"> 購入/販売不可</b></indent>"
info.weapon-winchester.icon	<sprite name="ui weapon winchester">
info.weapon-winchester.name	ウィンチェスター
info.weapon-winchester.desc	"大きな音と致命的な威力。微妙な作戦には向いていませんが、警察がすでに見て見ぬふりをしているときには大いに役立ちます。友人には、煙の出る方を向けないようにしましょう。\n\n低ダメージ: 50 — 高ダメージ: 100\n\n<indent=10><b>基本価格\n<sprite name="ui buy"> 購入/販売不可</b></indent>"
info.weapon-thompson.icon	<sprite name="ui weapon thompson">
info.weapon-thompson.name	トミーガン
info.weapon-thompson.desc	"狙いを定めるのが面倒な時のために。複数の敵と対峙する際には非常に優れていますが、精密な狙撃には不向きです。熟練した手に渡れば、すぐに街の恐怖の存在となるでしょう。\n\n低ダメージ: 60 — 高ダメージ: 100\n\n<indent=10><b>基本価格\n<sprite name="ui buy"> 購入/販売不可</b></indent>"
info.weapon-pistol.icon	<sprite name="ui weapon pistol">
info.weapon-pistol.name	ポケットピストル
info.weapon-pistol.desc	"有名なポケットサイズの効果的な武器。他の選択肢ほどの威力はありませんが、銃を持ち込むべきでない場所に忍び込むには最適です。\n\n低ダメージ: 40 — 高ダメージ: 90\n\n<indent=10><b>基本価格\n<sprite name="ui buy"> 購入/販売不可</b></indent>"
info.weapon-switchblade.icon	<sprite name="ui weapon knife">
info.weapon-switchblade.name	飛び出しナイフ
info.weapon-switchblade.desc	"大きな注目を集めることはないかもしれませんが、それでも十分に致命的です。スイッチブレードはクラシックな武器であり、軽んじてはいけません。熟練した手に握られれば、これ一つで十分に意図を伝えることができます。\n\n低ダメージ: 5 — 高ダメージ: 35\n\n<indent=10><b>基本価格\n<sprite name="ui buy"> 1本あたり $80</b></indent>"
info.homebooze-brick-wine.name	密造ブリックワイン製造所
info.homebooze-brick-wine.desc	"<indent=10>ブドウ濃縮物と陶器の壺からブリックワインを作ります。\n<b><sprite name="res grape-juice"> + <sprite name="res jugs"> <sprite name="ui arr sm right"> <sprite name="res brick-wine"></b>\n\n<b>必要条件:</b>\n<sprite name="skill brick-wine"> <link="brick-wine-making">ブリックワイン製造</link>、 <sprite name="res cash">700、 <sprite name="res lumber"> 4</indent>\n\n設置され、<link="grape-juice">ブドウ濃縮物</link>と<link="crocks">陶器の瓶</link>が供給されると、この秘密の作業場では<link="brick-wine">ブリックワイン</link>を生産し、街中のビジネスや自分の<link="backroom-bootlegger">秘密の密造者</link>やコーナーのスピークイージーで販売できます。また、ブリックワインは<link="production-fake-wine">秘密のワイン製造所</link>や<link="production-fake-wine-upgraded">秘密のワイナリー</link>を作れるようになれば、<link="fake-wine">偽ワイン</link>の製造にも使用できます。\n\n<i><indent=30>ワイン n. 発酵したブドウジュースのことで、婦人クリスチャン連合においては酒と呼ばれ、時にはラムとも呼ばれる。</i>\n</indent><indent=40>—アンブローズ・ビアス</indent>"
info.homebooze-cider.name	密造シードル製造所
info.homebooze-cider.desc	"<indent=10>リンゴジュースと陶器の壺からハードシードルを作ります。\n<b><sprite name="res apple-juice"> + <sprite name="res jugs"> <sprite name="ui arr sm right"> <sprite name="res cider"></b>\n\n<b>必要条件:</b>\n<sprite name="skill cider"> <link="cider-making">シードル製造</link>、<sprite name="res cash">800、<sprite name="res lumber"> 4</indent>\n\n設置され、<link="apple-juice">リンゴジュース</link>と<link="crocks">陶器の瓶</link>が供給されると、この秘密の作業場では<link="cider">ハードシードル</link>を生産し、街中のビジネスや自分の<link="backroom-bootlegger">秘密の密造者</link>やコーナーのスピークイージーで販売できます。また、ハードシードルは<link="production-sparkling-cider">スパークリングシードル製造所</link>や<link="production-sparkling-cider-upgraded">スパークリングシードル発酵器</link>を作れるようになれば、<link="sparkling-cider">スパークリングシードル</link>の製造にも使用できます。\n\n<i><indent=30>「1日1個のリンゴで医者いらず。」</i>\n</indent><indent=40>—禁酒運動によるハードシードル販売への影響を心配した果樹園経営者たちが採用したマーケティングスローガン</indent>"
info.homebooze-home-brew.name	密造自家製ビール製造所
info.homebooze-home-brew.desc	"<indent=10>麦芽シロップと陶器の壺を使って自家製ビールを作成します。\n<b><sprite name="res malt"> + <sprite name="res jugs"> <sprite name="ui arr sm right"> <sprite name="res home-brew"></b>\n\n<b>必要条件:</b>\n<sprite name="skill home-brew"> <link="home-brew-making">自家製ビールの生産</link>， <sprite name="res cash">1	000， <sprite name="res lumber"> 4</indent>\n\nこの密造事業が設置され、<link="malt">麦芽シロップ</link>と<link="crocks">陶器の壺</link>が供給されると、この事業は<link="home-brew">自家製ビール</link>を生産します。生産されたビールは、街中のビジネスに販売したり、自分の<link="backroom-bootlegger">密造酒販売所</link>や街角のスピークイージーで販売できます。自家製ビールは、<link="fake-beer">密造ビール</link>の生産にも利用でき、<link="production-fake-beer">密造ビール事業</link>や<link="production-fake-beer-upgraded">密造ビール醸造所</link>を建設する方法を学ぶことができます。\n\n<i><indent=30>「ビールは滅びゆく者のために、ワインは苦しむ者のために！彼らに飲ませよ、そして彼らの貧困を忘れ、もはやその苦しみを覚えさせるな。」</i>\n</indent><indent=40>— 『箴言』</indent>"
info.homebooze-moonshine.name	密造ムーンシャイン製造所
info.homebooze-moonshine.desc	"<indent=10>中性アルコールと陶器の壺からムーンシャインを作ります。\n<b><sprite name="res alcohol-btl"> + <sprite name="res jugs"> <sprite name="ui arr sm right"> <sprite name="res moonshine"></b>\n\n<b>必要条件:</b>\n<sprite name="skill moonshine"> <link="moonshine-making">ムーンシャイン製造</link>、<sprite name="res cash">600、<sprite name="res lumber"> 4</indent>\n\n設置され、<link="neutral-alcohol">中性アルコール</link>と<link="crocks">陶器の瓶</link>が供給されると、この秘密の作業場では<link="moonshine">ムーンシャイン</link>を生産し、街中のビジネスや自分の<link="backroom-bootlegger">秘密の密造者</link>やコーナーのスピークイージーで販売できます。また、ムーンシャインは<link="production-bathtub-gin">バスタブジン作業場</link>や<link="production-bathtub-gin-upgraded">バスタブジン蒸留器</link>を作れるようになれば、<link="bathtub-gin">バスタブジン</link>の製造にも使用できます。\n\n<i><indent=30>「まぁ、スコッチと何もないのなら、スコッチを選ぶだろうな。ムーンシャインに最も近いのがスコッチだ。」</i>\n</indent><indent=40>—ウィリアム・フォークナー</indent>"
info.homebooze-apple-jack.name	密造アップルジャック製造所
info.homebooze-apple-jack.desc	<b>一部の都市でのみ利用可能な事業</b>\n\n<indent=10>りんごまたはりんごジュース、氷、小瓶からアップルジャックを作る\n<sprite name="res apples"> + <sprite name="res ice"> +<sprite name="res small-bottles"><sprite name="ui arr sm right"><sprite name="res apple-jack">\n<b><sprite name="res apple-juice">+<sprite name="res ice">+<sprite name="res small-bottles"><sprite name="ui arr sm right"><sprite name="res apple-jack"></b>\n\n<b>必要なもの</b>\n<sprite name="skill applejacking"><link="homebooze-apple-jack">アップルジャックの製造</link>、<sprite name="res cash">900、<sprite name="res barrels">5</indent>\n\n<link="apples">りんご</link>または<link="apple-juice">りんごジュース</link>と、<link="small-bottles">小瓶</link>、<link="ice">氷</link>を供給することで街の企業や、あなたが所有する<link="backroom-bootlegger">密売店</link>またはもぐり酒場で販売できる<link="applejack">アップルジャック</link>を製造する。<link="production-sparkling-cider">スパークリングシードル製造所</link>や<link="production-sparkling-cider-upgraded">スパークリングシードル発酵槽</link>の構築方法を習得することで、<link="sparkling-cider">スパークリングシードル</link>の製造にアップルジャックを用いることも可能となる。\n\n<i><indent=30>1日1個のりんごで医者いらず。</i>\n</indent><indent=40>ー禁酒運動がハードシードルの販売に影響を与えることを懸念した果樹園のオーナーが採用したマーケティングスローガン</indent>
info.production-fruit-brandy.name	ラキヤ蒸留
info.production-fruit-brandy.desc	<b>一部の都市でのみ利用可能な事業</b>\n\n<indent=10>プラム、砂糖、小瓶からラキヤを作る\n<b><sprite name="res plums">+<sprite name="res small-bottles">+<sprite name="res sugar"><sprite name="ui arr sm right"><sprite name="res rakija"></b>\n\n<b>必要なもの</b>\n<sprite name="skill fruit brandy"><link="fruit-brandy-skill">プラムのブランデー</link>、<sprite name="res cash">1600、<sprite name="steel barrels">10、<sprite name="res pipes">5</indent>\n\n<link="plums">プラム</link>、<link="small-bottles">小瓶</link>、<link="sugar">砂糖</link>を供給することで街の企業や、あなたが所有する<link="backroom-bootlegger">密売店</link>またはもぐり酒場で販売できる<link="rakija">ラキヤ</link>を製造する。
info.production-corn-whiskey.name	コーンウイスキー蒸留
info.production-corn-whiskey.desc	<b>一部の都市でのみ利用可能な事業</b>\n\n<indent=10>コーンと瓶からコーンウイスキーを作る\n<b><sprite name="res corn">+<sprite name="res bottles"><sprite name="ui arr sm right"><sprite name="res corn whiskey"></b>\n\n<b>必要なもの</b>\n<sprite name="skill corn distillation"><link="corn-whiskey-skill">コーンウイスキー製造</link>、<sprite name="res cash">1800、<sprite name="res steel-barrels">5、<sprite name="res pipes">8</indent>\n\n<link="corn">コーン</link>、<link="bottles">瓶</link>を供給することで街の企業や、あなたが所有する<link="backroom-bootlegger">密売店</link>またはもぐり酒場で販売できる<link="corn-whiskey">コーンウイスキー</link>を製造する。
info.conversion-grape-juice.name	ブドウ圧縮
info.conversion-grape-juice.desc	<indent=10>ブドウと小樽からブドウ濃縮物を作る。\n<b><sprite name="res grapes"> + <sprite name="res half-barrel"> <sprite name="ui arr sm right"> <sprite name="res grape-juice"></b>\n\n<b>必要なもの:</b>\n<sprite name="skill grape-press"> <link="grape-press">ブドウ圧搾機</link>，  <sprite name="res cash">750，  <sprite name="res pipes"> 5，  <sprite name="res barrels"> 25，  <sprite name="res bricks"> 6</indent>\n\n<link="grapes">ブドウ</link>と<link="half-barrel">小樽</link>を供給すると、<link="grape-juice">ブドウ濃縮物</link>を生産し、<link="brick-wine">ブリックワイン</link>やその他の発酵や抽出に使用することができる。自前でブドウ濃縮物を作れば、市販のものを買うより確実で安価に入手できる。この作業を管理するのに適切な経験を積んだクルーは、これを改良ブドウ圧搾機にアップグレードすることができる。\n\n<i><indent=30>ブドウの紫は他のブドウの色を映しているのだ</i>\n</indent><indent=40>—ユウェナリス</indent>
info.conversion-apple-juice.name	りんごジュース圧搾
info.conversion-apple-juice.desc	<indent=10>りんごと小樽からりんごジュースを作る\n<b><sprite name="res apples">+<sprite name="res half-barrel"><sprite name="ui arr sm right"><sprite name="res apple-juice"></b>\n\n<b>必要なもの：</b>\n<sprite name="skill apple-press"><link="apple-press">りんご圧搾機</link>、<sprite name="res cash">750、<sprite name="res pipes">5、<sprite name="res half-barrel">25、<sprite name="res bricks">6</indent>\n\n<link="apples">りんご</link>と<link="half-barrel">小樽</link>を供給することで、<link="cider">ハードシードル</link>の材料として用いることができる<link="apple-juice">りんごジュース</link>を製造する。自前でりんごジュースを作れば、一般市場から購入するよりも安価かつ確実に入手することができる。 この製造所を管理するのに適切な経験を積んだ構成員を配置することで、改良型りんご圧搾機にアップグレードすることができます。\n\n<i><indent=30>シワシワのリンゴでも香りは良い。</i>\n</indent><indent=40>ーブルターニュの諺</indent>
info.conversion-neutral-alcohol.name	基礎的密造蒸留所
info.conversion-neutral-alcohol.desc	<indent=10>コーンシロップと瓶から中性アルコールを作る\n<b><sprite name="res corn-syrup">+<sprite name="res bottles"><sprite name="ui arr sm right"><sprite name="res alcohol-btl"></b>\n\n<b>必要なもの</b>\n<sprite name="skill backroom-distillation"><link="backroom-distillation">簡易蒸留所</link>、<sprite name="res cash">1500、<sprite name="res steel-barrels">25、<sprite name="res sheet metal">25</indent>\n<link="corn-syrup">コーンシロップ</link>と<link="bottles">瓶</link>を供給することで<link="moonshine">ムーンシャイン</link>や他の滋養強壮剤の原料として用いることができる<link="neutral-alcohol">中性アルコール</link>を製造する。自前で中性アルコールを作れば一般市場で購入するよりも安価かつ確実に入手することができる。この製造所を管理するのに適切な経験を積んだ構成員を配置することによって、改良型密造蒸留所にアップグレードすることができる。\n<i><indent=30>お酒は飲むときは飲むし、飲まないときは飲まない。</i>\n</indent><indent=40>ーミゲル・デ・セルバンテス</indent>\n\n
info.conversion-malt.name	モルト製造所
info.conversion-malt.desc	<indent=10>大麦から麦芽シロップを作成します。\n<b><sprite name="res barley"> <sprite name="ui arr sm right"> <sprite name="res malt"></b>\n\n<b>必要条件:</b>\n<sprite name="skill malt-making"> <link="malt-making">麦芽製造</link>， <sprite name="res cash">750， <sprite name="res pipes"> 5， <sprite name="res jugs"> 50， <sprite name="res bricks"> 6</indent>\n\nこの麦芽加工機が設置され、<link="barley">大麦</link>が供給されると、この加工機は<link="malt">麦芽シロップ</link>を生産し、自家製ビールの製造や醸造用途で使用できます。自分で麦芽シロップを作ることは、市場で購入するよりも信頼性が高く、コストを抑えられる場合があります。この事業の管理に必要な経験を積んだクルーメンバーがいれば、改善された麦芽加工機にアップグレードできます。\n\n<i><indent=30>「ビール醸造者は、質の悪い麦芽からでも非常に良いビールを作ることができるが、その努力を麦芽製造に向ければ、効果はさらに確実で信頼性が増す。」</i>\n</indent><indent=40>—ヘンリー・ストープス</indent>
info.conversion-ice-house.name	製氷所
info.conversion-ice-house.desc	<indent=10>水を氷に変える冷凍庫の動力源にガソリンを使用する。\n<b><sprite name="res gasoline"><sprite name="ui arr sm right"><sprite name="res ice"></b>\n\n<b>必要なもの</b>\n<sprite name="skill ice making"><link="ice-making">製氷</link>、<sprite name="res cash">800、<sprite name="res pipes">8、<sprite name="res lumber">8、<sprite name="res bricks">6</indent>\n\n<link="gasoline">ガソリン</link>を供給することで、<link="apple-jack">アップルジャック</link>と<link="champagne">シャンパン</link>の原料となる<link="ice">氷</link>を製造する。自前で氷を作ることで、一般市場から購入するよりも安価かつ確実に氷を入手することができる。\n\n<i><indent=30><i>文明は蒸留から始まる</i></indent>\n<indent=40>ーウィリアム・フォークナー</indent>
info.conversion-labels.name	偽造ラベル印刷工場
info.conversion-labels.desc	<indent=10>紙を偽造ラベルに変える\n<b><sprite name="res paper"><sprite name="ui arr sm right"><sprite name="res labels></b>\n\n<b>必要なもの：</b>\n<sprite name="skill labels"><link="label-counterfeiting">ラベルの偽造</link>、<sprite name="res sheet metal">5、<sprite name="res lumber">10、<sprite name="res bricks">10</indent>\n\n<link="paper">紙</link>を供給することで瓶入りの酒を造るのに不可欠な<link="labels>ラベル</link>を製造する。自前でラベルを作れば市場で購入するよりも確実かつ安価に手に入る。\n\n<i><indent=30><i>ワインを入れると、不思議なものが出てくる。</i></indent>\n<indent=40>ー-ヨハン・シラー</indent>
info.production-fake-wine.name	密造ワイン製造所
info.production-fake-wine.desc	"<indent=10>ブリックワインとラベルとボトルから偽造ワインを製造する。\n<b><sprite name="res brick-wine"> + <sprite name="res bottles"> + <sprite name="res labels"> <sprite name="ui arr sm right"> <sprite name="res fake-wine"></b>\n\n<b>必要なもの:</b>\n<sprite name="skill fake-wine"> <link="fake-wine-skill">裏ワイン醸造所</link>，  <sprite name="res cash">2000，  <sprite name="res barrels"> 20，  <sprite name="res pipes"> 5，  <sprite name="res bricks"> 7</indent>\n\n<link="homemade-booze">自家製酒</link>は直接販売することもできるし、かなり収益性の高い<link="refined-booze">精製酒</link>の基礎として使用することもできる。この作業は、<link="brick-wine">ブリックワイン</link>を<link="bottle">ボトル</link>に入れ、それぞれに<link="labels">ラベル</link>を貼ることで <link="fake-wine"> 偽造ワイン</link> を作るものだ。出来上がった製品は、街中の多くの業者に売ったり、自分の<link="corner-speakeasy">潜り酒場</link>やサパークラブで自分で動かしたりすることが可能だ。<link="production-fake-wine-upgraded">裏ワイナリー</link> にアップグレードして、<link="grape">ブドウ</link>から直接偽造ワインを作ることもできる。\n\n<i><indent=30>ワインは科学的なルールに従った製造ではなく、味覚にのみ依存する芸術である。\n</indent><indent=40>-レイモンド・デュメイ</indent>"
info.production-fake-wine-upgraded.name	密造ワイナリー
info.production-fake-wine-upgraded.desc	"<indent=10>ブドウとラベルとボトルから偽造ワインを作る。\n<b><sprite name="res grapes"> + <sprite name="res bottles"> + <sprite name="res labels"> <sprite name="ui arr sm right"> <sprite name="res fake-wine"></b>\n\n<b>必要なもの:</b>\n<sprite name="skill fake-wine"> <link="fake-wine-skill">裏ワイン醸造所</link> と <sprite name="skill grape-press"> <link="grape-press">ぶどう圧搾機</link>， <sprite name="res cat materials"> 建材</indent>\n\nこのアップグレードは、<link="production-fake-wine">裏ワイン製造所</link> に直接ワイン圧搾機を設置し、<link="brick-wine">ブリックワイン</link>ではなく <link="grapes">ぶどう</link> から直接 <link="fake-wine"> 偽造ワイン</link> を生産できるようにするためのものである。\n\n<i><indent=30>ワインは科学的なルールに従った製造ではなく、味覚にのみ依存する芸術である。\n</indent><indent=40>-レイモンド・デュメイ</indent>。"
info.production-sparkling-cider.name	スパークリングシードル製造所
info.production-sparkling-cider.desc	"<indent=10>ハードシードル、砂糖、小瓶からスパークリングシードルを作ります。\n<b><sprite name="res cider"> + <sprite name="res small-bottles"> + <sprite name="res sugar"> <sprite name="ui arr sm right"> <sprite name="res sparkling-cider"></b>\n\n<b>必要条件:</b>\n<sprite name="skill sparkling-cider"> <link="sparkling-cider-skill">スパークリングシードル製造</link>、<sprite name="res cash">2000、<sprite name="res steel-barrels"> 25、<sprite name="res pipes"> 4、<sprite name="res bricks"> 8</indent>\n\n<link="homemade-booze">自家製酒</link>は直接販売することもできますが、<link="refined-booze">精製酒</link>としてより収益性の高い製品にすることも可能です。この作業場では、<link="cider">シードル</link>の陶器の瓶を使い、<link="small-bottles">小瓶</link>に入れ、適量の<link="sugar">砂糖</link>を加えてスパークリングシードルを作ります。砂糖は少しだけ発泡させる程度に加え、爆発しないように調整します。出来上がった製品は街中の多くのビジネスに販売できるほか、自分の<link="corner-speakeasy">スピークイージー</link>やサパークラブでも販売できます。また、<link="production-sparkling-cider-upgraded">スパークリングシードル発酵器</link>に<link="production-sparkling-cider-upgraded">アップグレード</link>することで、<link="apples">リンゴ</link>から直接スパークリングシードルを作ることが可能です。\n\n<i><indent=30>「なんというエネルギー、なんという産業の熱狂！ ピッツバーグのすべてが夜明け前から働いている！これはシカゴをも凌駕する。こんな無謀なまでのビジネスへの献身を、豪奢なセントルイスは何と言うだろうか？」</i>\n</indent><indent=40>—ジェームズ・パートン</indent>"
info.production-sparkling-cider-upgraded.name	スパークリングシードルの発酵槽
info.production-sparkling-cider-upgraded.desc	<indent=10>りんご、砂糖、小瓶からスパークリングシードルを作る\n<b><sprite name="res apples">+<sprite name="res small-bottles">+<sprite name="res sugar"><sprite name="ui arr sm right"><sprite name="res sparkling-cider"></b>\n\n<b>必要なもの：</b>\n<sprite name="skill sparkling-cider"><link="sparkling-cider-skill">スパークリングシードル</link>と<sprite name="skill apple-press"><link="apple-press">りんご圧搾機</link>、<sprite name="res cat materials">建材</indent>\n\nこのアップグレードは<link="production-sparkling-cider">スパークリングシードル製造所</link>にりんご圧搾機を設置することで、<link="cider">ハードシードル</link>を使わずに<link="apples">りんご</link>から直接<link="sparkling-cider">スパークリングシードル</link>を製造できる様になる。\n\n<i><indent=30>なんというエネルギーッ！なんという産業の猛威ッ! 夜明け前からピッツバーグが働いているッ！これはシカゴを凌駕する。このような向こう見ずなビジネスへの献身を、豪華なセントルイスは何と言うでしょう？</i>\n</indent><indent=40>ージェームズ・パートン</indent>
info.homebooze-moonshine-still.name	密造ムーンシャイン蒸留
info.homebooze-moonshine-still.desc	"<b>地域限定の作業は一部の都市でのみ利用可能です。</b>\n\n<indent=10>トウモロコシ、鉄製の樽、陶器の瓶からムーンシャインを作ります。\n<b><sprite name="res corn"> + <sprite name="res steel-barrels"> + <sprite name="res jugs"> <sprite name="ui arr sm right"> <sprite name="res moonshine"></b>\n\n<b>必要条件:</b>\n<sprite name="skill moonshine"> <link="moonshine-distillation">ムーンシャイン蒸留器</link> <sprite name="res cash">1000、<sprite name="res steel-barrels"> 10、<sprite name="res lumber"> 4</indent>\n\n設置され、<link="corn">トウモロコシ</link>、<link="steel-barrels">鉄製の樽</link>、<link="crocks">陶器の瓶</link>が供給されると、この秘密の作業場では<link="moonshine">ムーンシャイン</link>を生産し、街中のビジネスや自分の<link="backroom-bootlegger">秘密の密造者</link>やコーナーのスピークイージーで販売できます。また、ムーンシャインは<link="production-bathtub-gin">バスタブジン作業場</link>や<link="production-bathtub-gin-upgraded">バスタブジン蒸留器</link>を作れるようになれば、<link="bathtub-gin">バスタブジン</link>の製造にも使用できます。\n\n<i><indent=30>「まぁ、スコッチと何もないのなら、スコッチを選ぶだろうな。ムーンシャインに最も近いのがスコッチだ。」</i>\n</indent><indent=40>—ウィリアム・フォークナー</indent>"
info.homebooze-fruit-wine.name	密造フルーツワイン事業
info.homebooze-fruit-wine.desc	<b>一部の都市でのみ利用可能な事業</b>\n\n<indent=10>フルーツ、砂糖、小瓶からフルーツワインを作る。\n<b><sprite name="res fruit">+<sprite name="res sugar">+<sprite name="res small-bottles"><sprite name="ui arr sm right"><sprite name="res fruit-wine"></b>\n\n<b>必要なもの：</b>\n<sprite name="skill fruit-wine"><link="fruitful-operations">フルーツワイン製造所</link>、<sprite name="res cash">950、<sprite name="res half-barrel">8</indent>\n\n<link="fruit-other">フルーツ</link>、<link="sugar">砂糖</link>、<link="small-bottles">小瓶</link>を供給することで、街の企業やあなたが所有する<link="backroom-bootlegger">密売店</link>または<link="corner-speakeasy">潜り酒場</link>で販売できる<link="fruit-wine">フルーツワイン</link>を製造する。\n\n<indent=30><i>調理にワインを使うことはもちろん、料理にワインをぶっかけることもあります。</i></indent>\n<indent=40>ーW・C・フィールズ</indent>
info.makeshift-whiskey.name	その場しのぎのウイスキー蒸留
info.makeshift-whiskey.desc	"<indent=10>ムーンシャイン、スパイス、食品用着色料、瓶から瓶詰めウイスキーを作る\n<b><sprite name="res moonshine">+<sprite name="res spices">+<sprite name="res food-dye">+<sprite name="res bottles"><sprite name="ui arr sm right"><sprite name="res whisky"></b>\n\n<b>必要なもの：</b>\n<sprite name="skill whiskey-bottled"><link="bootleg-whiskey">密造ウイスキー</link>	\n<sprite name="res cash">5000、<sprite name="res steel-barrels">10、<sprite name="res pipes">15、<sprite name="res bricks">15、<sprite name="res lumber">15</indent>\n\n余った<link="moonshine">ムーンシャイン</link>に<link="spices">スパイス</link>と<link="food-dyes">食品用着色料</link>を混ぜて出来上がったものを<link="bottles">瓶</link>に詰めることで<link="whiskey-bottled">瓶詰めウイスキー</link>を製造することが可能となる。そして、それを顧客に渡したり、サパークラブやイベント会場で自分で販売したりすることができる。\n\n<indent=30><i>愛が世界を動かすって？そんなことはない。ウィスキーはその2倍の速さで世界を動かすさ。</i></indent>\n<indent=40>ーコンプトン・マッケンジー</indent>"
info.makeshift-brandy.name	その場しのぎのブランデー蒸留
info.makeshift-brandy.desc	"<indent=10>ブリックワインまたは果実酒、それに果実と瓶から瓶詰めのブランデーを作ることができる。\n<b><sprite name="res brick-wine">/<sprite name="res fruit-wine"> + <sprite name="res fruit"> + <sprite name="res bottles"> <sprite name="ui arr sm right"> <sprite name="res brandy"></b>\n\n<b>必要なもの:</b>\n<sprite name="skill brandy-bottled"> <link="bootleg-brandy">密造ブランデー</link>，  <sprite name="res cash">4500，  <sprite name="res barrels"> 20，  <sprite name="res pipes"> 15，  <sprite name="res bricks"> 15，  <sprite name="res lumber"> 15</indent>\n\nこの製造所を設置すると、余った<link="brick-wine">ブリックワイン</link>や<link="fruit-wine">フルーツワイン</link>に<link="fruit-other">果物を混ぜ、少し置いてから<link="bottle">ボトルに詰めて</link>ブランデーにすることが可能になる。顧客に渡したりサパークラブやイベント会場で自分で売ったりすることができる。\n\n<indent=30><i>人はワインやブランデーの味を覚え、水への愛情を失うかもしれない、しかし我々は彼を哀れむべきでない。\n<indent=40>-ヘンリー・デイヴィッド・ソロー</indent>。\n"
info.makeshift-vodka.name	その場しのぎのウォッカ蒸留
info.makeshift-vodka.desc	<indent=10>自家製ビール、コーンシロップ、瓶から瓶詰めウォッカを作る。\n<b><sprite name="res home-brew">+<sprite name="res corn-syrup">+<sprite name="res bottles"><sprite name="ui arr sm right"><sprite name="res vodka"></b>\n\n<b>必要なもの：</b>\n<sprite name="skill vodka-bottled"><link="bootleg-brandy">密造ウォッカ</link>、<sprite name="res cash">3500、<sprite name="res half-barrel">24、<sprite name="res sheet metal">12、<sprite name="res bricks">12、<sprite name="res lumber">12</indent>\n\n余った<link="home-brew">自家製ビール</link>を発酵・蒸留することで<link="vodka-bottled">瓶詰めウォッカ</link>にすることが可能となる。蒸留前に<link="corn-syrup">コーンシロップ</link>で酵母を活性化させれば、<link="bottles">瓶</link>を充たす強い酒が出来上がる。顧客に渡したり、サパークラブやイベント会場で自分で販売したりすることができる。\n\n<indent=30><i>金はウォッカと同じで人を狂わせる</i></indent>\n<indent=40>ーアントン・チェーホフ</indent>
info.makeshift-rum.name	その場しのぎのラム蒸留
info.makeshift-rum.desc	<indent=10>中性アルコール、砂糖、瓶から瓶詰めラム酒を作る。\n<b><sprite name="res alcohol-btl">+<sprite name="res sugar">+<sprite name="res bottles"><sprite name="ui arr sm right"><sprite name="res rum"></b>\n\n<b>必要なもの：</b>\n<sprite name="skill rum-bottled"><link="bootleg-rum">密造ラム酒</link>、<sprite name="res cash">4000、<sprite name="res steel-barrels">16、<sprite name="res sheet metal">12、<sprite name="res bricks">12、<sprite name="res lumber">12</indent>\n\nこの製造所によって<link="sugar">砂糖</link>を煮詰めてカラメルを作り<link="neutral-alcohol">中性アルコール</link>と混ぜることが可能となる。こうして出来た暗色の液体を<link="bottles">瓶</link>に詰めて出来るのが<link="rum-bottled">瓶詰めラム酒</link>であり、顧客に渡したり、サパークラブやイベント会場で自分で販売したりすることができる。\n\n<indent=30><i>ラム酒と真の宗教ほど、精神を落ち着かせるものはないだろう。</i></indent>\n<indent=40>ーバイロン卿</indent>
info.still-whiskey.name	小さなウイスキー蒸留器
info.still-whiskey.desc	"<indent=10>ライ麦または小麦と樽からウィスキー樽を作ります。\n<b><sprite name="res rye"> / <sprite name="res wheat"> + <sprite name="res barrels"> <sprite name="ui arr sm right"> <sprite name="res whiskey-barrel"></b>\n\n<b>必要条件:</b>\n<sprite name="skill whiskey-still"> <link="whiskey-still">小型ウィスキー蒸留器</link>、<sprite name="res cash">7500、<sprite name="res sheet metal"> 30、<sprite name="res pipes"> 24、<sprite name="res lumber"> 24、<sprite name="res steel-barrels"> 16</indent>\n\nあなたの組織が本格的に違法な酒を大量生産することを考慮する時が来るかもしれません。この作業場を組織が管理する建物に設置することで、<link="wheat">小麦</link>または<link="rye">ライ麦</link>を<link="whiskey-barrel">ウィスキー樽</link>に変えることができます。ウィスキー樽をそのまま卸売りするか、瓶詰め作業場に運んで<link="whiskey-bottled">瓶詰めウィスキー</link>に変換するか、さらにはより高級な酒を作るために使用することができます。\n\n<indent=30><i>「愛が世界を回す？いや、ウィスキーが世界を2倍の速さで回すんだ。」</i></indent>\n<indent=40>—コンプトン・マッケンジー</indent>"
info.still-brandy.name	小さなブランデー蒸留器
info.still-brandy.desc	"<indent=10>果物やリンゴと樽からブランデー樽を作ります。\n<b><sprite name="res fruit"> / <sprite name="res apples"> + <sprite name="res barrels"> <sprite name="ui arr sm right"> <sprite name="res brandy-barrel"></b>\n\n<b>必要条件:</b>\n<sprite name="skill brandy-still"> <link="brandy-still">小型ブランデー蒸留器</link>、<sprite name="res cash">7000、<sprite name="res sheet metal"> 30、<sprite name="res pipes"> 24、<sprite name="res lumber"> 24、<sprite name="res steel-barrels"> 16</indent>\n\nあなたの組織が本格的に違法な酒を大量生産することを考慮する時が来るかもしれません。この作業場を組織が管理する建物に設置することで、<link="fruit-other">果物</link>または<link="apples">リンゴ</link>を<link="brandy-barrel">ブランデー樽</link>に変えることができます。ブランデー樽をそのまま卸売りするか、瓶詰め作業場に運んで<link="brandy-bottled">瓶詰めブランデー</link>に変換することができます。\n\n<indent=30><i>「人はワインやブランデーの味を覚え、水への愛を失うこともある。しかし、そのことを憐れむ必要はない。」</i></indent>\n<indent=40>—ヘンリー・デイヴィッド・ソロー</indent>"
info.still-vodka.name	小さなウォッカ蒸留器
info.still-vodka.desc	"<indent=10>大麦やライ麦と樽からウォッカ樽を作ります。\n<b><sprite name="res barley"> / <sprite name="res rye"> + <sprite name="res barrels"> <sprite name="ui arr sm right"> <sprite name="res vodka-barrel"></b>\n\n<b>必要条件:</b>\n<sprite name="skill vodka-still"> <link="vodka-still">小型ウォッカ蒸留器</link>、<sprite name="res cash">5000、<sprite name="res half-barrel"> 24、<sprite name="res pipes"> 24、<sprite name="res lumber"> 12、<sprite name="res steel-barrels"> 16</indent>\n\nあなたの組織が本格的に違法な酒を大量生産することを考慮する時が来るかもしれません。この作業場を組織が管理する建物に設置することで、<link="barley">大麦</link>または<link="rye">ライ麦</link>を<link="vodka-barrel">ウォッカ樽</link>に変えることができます。ウォッカ樽をそのまま卸売りするか、瓶詰め作業場に運んで<link="vodka-bottled">瓶詰めウォッカ</link>に変換するか、さらにはより高級な酒を作るために使用することができます。\n\n<indent=30><i>「お金もウォッカも、人を変わり者にする。」</i></indent>\n<indent=40>—アントン・チェーホフ</indent>"
info.still-rum.name	小さなラム蒸留器
info.still-rum.desc	"<indent=10>砂糖やコーンシロップと樽からラム酒の樽を作ります。\n<b><sprite name="res sugar"> / <sprite name="res corn-syrup"> + <sprite name="res barrels"> <sprite name="ui arr sm right"> <sprite name="res barrel-rum"></b>\n\n<b>必要条件:</b>\n<sprite name="skill rum-still"> <link="rum-still">小型ラム酒蒸留器</link>、<sprite name="res cash">5000、<sprite name="res bricks"> 24、<sprite name="res pipes"> 24、<sprite name="res sheet metal"> 12、<sprite name="res steel-barrels"> 16</indent>\n\nあなたの組織が本格的に違法な酒を大量生産することを考慮する時が来るかもしれません。この作業場を組織が管理する建物に設置することで、<link="sugar">砂糖</link>または<link="corn-syrup">コーンシロップ</link>を<link="rum-barrel">ラム酒樽</link>に変えることができます。ラム酒樽をそのまま卸売りするか、瓶詰め作業場に運んで<link="rum-bottled">瓶詰めラム酒</link>に変換するか、さらにはより高級な酒を作るために使用することができます。\n\n<indent=30><i>「ラム酒と真の宗教ほど心を落ち着かせるものはない。」</i></indent>\n<indent=40>—ロード・バイロン</indent>"
info.bottling-operation.name	瓶詰め事業
info.bottling-operation.desc	<indent=10>様々な種類の酒樽を瓶詰めの酒に変える。\n<b><sprite name="res whiskey-barrel">/<sprite name="res brandy-barrel">/<sprite name="res vodka-barrel">/<sprite name="res barrel-rum"> + <sprite name="res bottles"> + <sprite name="res labels"><sprite name="ui arr sm right">/<sprite name="res whisky">/<sprite name="res brandy">/<sprite name="res vodka">/<sprite name="res rum"></b>\n\n<b>必要なもの：</b>\n<sprite name="skill booze-bottling"><link="booze-bottling">酒の瓶詰め</link>、<sprite name="res cash">1500、<sprite name="res lumber">10、<sprite name="res pipes">6、</indent>\n酒樽の供給源が確保できたら、それを瓶詰めして顧客に売ったり自分が所有する事業に運び込む方法が必要となる。瓶詰め作業所を建設すれば、<link="whiskey-barrel">ウイスキー樽</link>、<link="brandy-barrel">ブランデー樽</link>、<link="vodka-barrel">ウォッカ樽</link>、<link="rum-barrel">ラム樽</link>を<link="bottles">瓶</link>に詰めて<link="labels">偽造ラベル</link>を貼り付けることで瓶入りの酒にすることができる。\n
info.production-fake-beer.name	密造ビール事業
info.production-fake-beer.desc	"<indent=10>自家製ビール、ホップ、小瓶から密造ビールを作ります。\n<b><sprite name="res home-brew"> + <sprite name="res small-bottles"> + <sprite name="res hops"> <sprite name="ui arr sm right"> <sprite name="res fake-beer"></b>\n\n<b>必要条件:</b>\n<sprite name="skill fake-beer"> <link="fake-beer-skill">密造ビール醸造</link>、<sprite name="res cash">1600、<sprite name="res steel-barrels"> 25、<sprite name="res pipes"> 5、<sprite name="res bricks"> 4</indent>\n\n<link="homemade-booze">自家製酒</link>は直接販売することもできますが、<link="refined-booze">精製酒</link>として使用することで、より収益性の高い商品となります。この作業場では、<link="home-brew">自家製ビール</link>を陶器の瓶に入れ、<link="small-bottles">小瓶</link>に移してから、事前に<link="hops">ホップ</link>を混ぜて本物のビールの香りと風味を加え、<link="fake-beer">密造ビール</link>を作ります。この製品は、市内のさまざまなビジネスに販売できるほか、<link="corner-speakeasy">スピークイージー</link>やサパークラブで自ら販売することも可能です。また、<link="production-fake-beer-upgraded">密造ビール醸造所</link>にアップグレードすることで、<link="barley">大麦</link>から直接密造ビールを作ることができます。\n\n<indent=30><i>「詩人たる者の最初の義務は、ビールに慣れることだ。」</i></indent>\n<indent=40>—ヴィルヘルム・ブッシュ</indent>"
info.production-fake-beer-upgraded.name	密造ビール醸造所
info.production-fake-beer-upgraded.desc	"<indent=10>大麦、ホップ、小瓶から密造ビールを作ります。\n<b><sprite name="res barley"> + <sprite name="res small-bottles"> + <sprite name="res hops"> <sprite name="ui arr sm right"> <sprite name="res fake-beer"></b>\n\n<b>必要条件:</b>\n<sprite name="skill fake-beer"> <link="fake-beer-skill">密造ビール醸造</link>と<sprite name="skill malt-making"> <link="malt-making">モルト製造</link>、<sprite name="res cat materials"> 建設資材</sprite></indent>\n\nこのアップグレードでは、<link="production-fake-beer">密造ビール作業場</link>に小さな醸造タンクを直接設置し、<link="home-brew">自家製ビール</link>ではなく、<link="barley">大麦</link>から直接密造ビールを生産できるようにします。\n\n<indent=30><i>「詩人たる者の最初の義務は、ビールに慣れることだ。」</i></indent>\n<indent=40>—ヴィルヘルム・ブッシュ</indent>"
info.production-bathtub-gin.name	バスタブ・ジン製造
info.production-bathtub-gin.desc	"<indent=10>ムーンシャイン、スパイス、小瓶からバスタブジンを作ります。\n<b><sprite name="res moonshine"> + <sprite name="res small-bottles"> + <sprite name="res spices"> <sprite name="ui arr sm right"> <sprite name="res bathtub-gin"></b>\n\n<b>必要条件:</b>\n<sprite name="skill bathtub-gin"> <link="bathtub-gin-skill">バスタブジン作業場</link>、<sprite name="res cash">2500、<sprite name="res half-barrel"> 25、<sprite name="res pipes"> 4、<sprite name="res bricks"> 4</indent>\n\n<link="homemade-booze">自家製酒</link>は直接販売することもできますが、<link="refined-booze">精製酒</link>として使用することで、より収益性の高い商品となります。この作業場では、<link="moonshine">ムーンシャイン</link>を陶器の瓶に入れ、<link="small-bottles">小瓶</link>に移してから、事前に<link="spices">スパイス</link>を混ぜてさまざまなカクテルに適した飲み物を作り、<link="bathtub-gin">バスタブジン</link>を製造します。この製品は、市内のさまざまなビジネスに販売できるほか、<link="corner-speakeasy">スピークイージー</link>やサパークラブで自ら販売することも可能です。また、<link="production-bathtub-gin-upgraded">バスタブジン蒸留器</link>にアップグレードすることで、<link="corn-syrup">コーンシロップ</link>から直接バスタブジンを作ることができます。\n\n<indent=30><i>「ジョージアにいたときはとても順調だった。ここシカゴに来てからは、地獄ばかりだ。」</i></indent>\n<indent=40>—ココモ・アーノルド『Red Beans and Rice』より</indent>"
info.production-bathtub-gin-upgraded.name	バスタブ・ジン醸造所
info.production-bathtub-gin-upgraded.desc	"<indent=10>コーンシロップ、ホップ、小瓶からバスタブジンを作ります。\n<b><sprite name="res corn-syrup"> + <sprite name="res small-bottles"> + <sprite name="res spices"> <sprite name="ui arr sm right"> <sprite name="res bathtub-gin"></b>\n\n<b>必要条件:</b>\n<sprite name="skill bathtub-gin"> <link="bathtub-gin-skill">バスタブジン作業場</link>と<sprite name="skill backroom-distillation"> <link="backroom-distillation">密造蒸留</link>、<sprite name="res cat materials">建設資材</sprite></indent>\n\nこのアップグレードでは、<link="production-bathtub-gin">バスタブジン作業場</link>に小型の蒸留器を直接設置し、<link="moonshine">ムーンシャイン</link>ではなく、<link="corn-syrup">コーンシロップ</link>から直接バスタブジンを生産できるようにします。\n\n<indent=30><i>「ジョージアにいたときはとても順調だった。ここシカゴに来てからは、地獄ばかりだ。」</i></indent>\n<indent=40>—ココモ・アーノルド『Red Beans and Rice』より</indent>"
info.backroom-bootlegger.name	密売店
info.backroom-bootlegger.desc	"<indent=10>１種類の自家製酒のみ販売できる。\n<b><sprite name="res brick-wine"> <sprite name="res cider"> <sprite name="res home-brew"> <sprite name="res moonshine"> <sprite name="res apple-jack"> <sprite name="res fruit-wine"></b>\n\n<b>必要な物:</b>\n<sprite name="ui skills">密造店，  <sprite name="res cash">1，000，  <sprite name="res lumber"> 10</indent>\n\nこの非常にシンプルな流通オペレーションは、他のビジネスに供給する代わりに、1種類の自家製酒を直接顧客に販売することができます。拡張密売店を学ぶと、2種類目の自家製酒を販売するように事業をアップグレードすることができます。\n\n<i><indent=30>誰も私を試さないでください、決して勝てないからです。俺は陸軍、海軍、俺と俺のジンだけで戦う。どんな密輸業者も私の友人だ</i>\n</indent><indent=40>—ベッシー・スミス "ミー・アンド・マイ・ジン "より</indent>"
info.corner-speakeasy.name	街角潜り酒場
info.corner-speakeasy.desc	"<indent=10>すべての種類の自家製酒を販売できます。\n<b><sprite name="res brick-wine"> <sprite name="res cider"> <sprite name="res home-brew"> <sprite name="res apple-jack"> <sprite name="res fruit-wine"> <sprite name="res moonshine"></b>\nおよび1種類の精製酒\n<sprite name="res fake-wine"> <sprite name="res fake-beer"> <sprite name="res sparkling-cider"> <sprite name="res bathtub-gin"> <sprite name="res rakija"> <sprite name="res corn whiskey"></b>\n\n<b>必要条件:</b>\n<sprite name="ui skills"> コーナースピークイージー、<sprite name="res cash">5	000、<sprite name="res lumber"> 20、<sprite name="res furniture"> 30</indent>\n\n簡単な木製のバー、適当なグラス類、そして酒を隠しておける場所があれば、この基本的なスピークイージーは運営できます。この作業場では、すべての種類の自家製酒と1種類の精製自家製酒を販売することができます。\n\n<indent=30><i>「昨夜遅く、泣きながら売り払った。シカゴに向かうブルースで、どうしても満足できない。」</i></indent>\n<indent=40>—ベッシー・スミス『Chicago Bound Blues』より</indent>"
info.small-speakeasy.name	小型潜り酒場
info.small-speakeasy.desc	"<indent=10>すべての種類の精製酒を販売できます。\n<b><sprite name="res fake-wine"> <sprite name="res fake-beer"> <sprite name="res sparkling-cider"> <sprite name="res bathtub-gin"> <sprite name="res rakija"> <sprite name="res corn whiskey"></b>\nおよび1種類の瓶詰め酒\n<sprite name="res whisky"> <sprite name="res brandy"> <sprite name="res vodka"> <sprite name="res rum"></b>\n\n<b>必要条件:</b>\n<sprite name="ui skills"> 小型スピークイージー、<sprite name="res cash">7	500、<sprite name="res lumber"> 40、<sprite name="res furniture"> 40</indent>\n\n頑丈なバー、高品質の酒、そして散らばったテーブルと椅子があれば、この小さなスピークイージーに人々が絶えず流れ込むでしょう。この作業場では、すべての種類の精製酒と1種類の瓶詰め酒を販売することができます。\n\n<indent=30><i>「昨夜遅く、泣きながら売り払った。シカゴに向かうブルースで、どうしても満足できない。」</i></indent>\n<indent=40>—ベッシー・スミス『Chicago Bound Blues』より</indent>"
info.garage-module.name	ガレージ
info.garage-module.desc	"<indent=10>組織が同時に維持できる車両の台数を増やし、安価な修理サービスを提供します。\n\n<b>必要条件:</b>\n<sprite name="skill garages"> <link="small-garages">ガレージ建設</link>、<sprite name="res cash">250、<sprite name="res bricks"> 5、<sprite name="res sheet metal"> 2</indent>\n\n設置すると、組織の車両用の追加駐車スペースを提供し、安価な修理に使用できます。\n\n<indent=30><i>「私は理想主義者だ。どこに向かっているかはわからないが、進んでいることは確かだ。」</i></indent>\n<indent=40>—カール・サンドバーグ</indent>"
info.truck-garage-module.name	トラック修理ベイ
info.truck-garage-module.desc	"<indent=10>組織が同時に維持できるトラックの台数を増やし、安価な修理サービスを提供します。\n\n<b>必要条件:</b>\n<sprite name="skill truck-bays"> <link="truck-garage">トラック修理ベイ</link>、<sprite name="res cash">750、<sprite name="res bricks"> 6、<sprite name="res sheet metal"> 4</indent>\n\n設置すると、組織のトラック用の追加駐車スペースを提供し、安価な修理に使用できます。\n\n<indent=30><i>「私は理想主義者だ。どこに向かっているかはわからないが、進んでいることは確かだ。」</i></indent>\n<indent=40>—カール・サンドバーグ</indent>"
info.production-champagne.name	シャンパン製造
info.production-champagne.desc	<indent=10>ラベル、氷、砂糖、偽造ワインからシャンパンを造る\n<b><sprite name="res labels">+<sprite name="res ice">+<sprite name="res sugar">+<sprite name="res fake-wine"><sprite name="ui arr sm right"><sprite name="res champagne"></b>\n\n<b>必要なもの：</b>\n<sprite name="skill champagne"><link="champagne-making">シャンパンの製法</link>、<sprite name="res cash">5000、<sprite name="res barrels">50、<sprite name="res pipes">20、<sprite name="res lumber">20、<sprite name="res sheet metal">20</indent>\n\n<link="labels">偽造ラベル</link>、<link="ice">氷</link>、<link="sugar">砂糖</link>、<link="fake-wine">偽造ワイン</link>を供給することで、街中の商店やあなたが経営する事業で販売できる<link="champagne">シャンパン</link>を製造する。
info.production-dark-rum.name	スパイス入りラム酒製造
info.production-dark-rum.desc	"<indent=10>ラベル、オーク樽、スパイス、小瓶、ラム樽からスパイス入りラム酒を作ります。\n<b><sprite name="res labels"> + <sprite name="res oak-barrels"> + <sprite name="res spices"> + <sprite name="res small-bottles"> <sprite name="ui arr sm right"> <sprite name="res dark rum"></b>\n\n<b>必要条件:</b>\n<sprite name="skill dark-rum"><link="dark-rum-making">スパイスラム製造</link>、<sprite name="res cash">5000、<sprite name="res half-barrel">50、<sprite name="res pipes">20、<sprite name="res lumber">20、<sprite name="res bricks">20</indent>\n\n設置され、<link="labels">偽造ラベル</link>、<link="oak-barrels">オーク樽</link>、<link="spices">スパイス</link>、<link="small-bottles">小瓶</link>が供給されると、この作業場は<link="dark-rum">スパイスラム</link>を生産し、市内のビジネスや自社の施設で販売することができます。"
info.production-beer-kegs.name	大規模醸造所
info.production-beer-kegs.desc	"<indent=10>スチール樽、氷、密造ビールからビール樽を作ります。\n<b><sprite name="res steel-barrels"> + <sprite name="res ice"> + <sprite name="res fake-beer"> <sprite name="ui arr sm right"> <sprite name="res beer-keg"></b>\n\n<b>必要条件:</b>\n<sprite name="skill beer-kegs"><link="beer-kegs-skill">樽ビール製造</link>、<sprite name="res cash">4000、<sprite name="res steel-barrels">20、<sprite name="res ice">30、<sprite name="res fake-beer">20</indent>\n\n設置され、<link="steel-barrels">スチール樽</link>、<link="ice">氷</link>、<link="fake-beer">密造ビール</link>が供給されると、この作業場は<link="beer-keg">ビール樽</link>を生産し、市内のビジネスや自社の施設で販売することができます。"
info.production-aged-whiskey.name	熟成ウイスキー製造
info.production-aged-whiskey.desc	"<indent=10>ラベル、オーク樽、小瓶、ウィスキー樽から熟成ウィスキーを作ります。\n<b><sprite name="res labels"> + <sprite name="res oak-barrels"> + <sprite name="res small-bottles"> + <sprite name="res whiskey-barrel"> <sprite name="ui arr sm right"> <sprite name="res aged whiskey"></b>\n\n<b>必要条件:</b>\n<sprite name="skill aged-whiskey"><link="aged-whiskey-skill">長年のウィスキー熟成</link>、<sprite name="res cash">5000、<sprite name="res barrels">50、<sprite name="res pipes">20、<sprite name="res lumber">20、<sprite name="res sheet metal">20</indent>\n\n設置され、<link="labels">偽造ラベル</link>、<link="oak-barrels">オーク樽</link>、<link="small-bottles">小瓶</link>、<link="whiskey-barrel">ウィスキー樽</link>が供給されると、この作業場は<link="aged-whiskey">熟成ウィスキー</link>を生産し、市内のビジネスや自社の施設で販売することができます。"
info.production-cordial.name	コーディアル製造
info.production-cordial.desc	"<indent=10>ラベル、果物、氷、瓶、ウォッカ樽または中性アルコールからリキュールを作ります。\n<b><sprite name="res labels"> + <sprite name="res fruit"> + <sprite name="res ice"> + <sprite name="res bottles"> + <sprite name="res vodka-barrel"> <sprite name="ui arr sm right"> <sprite name="res cordials">\n<sprite name="res labels"> + <sprite name="res citrus"> + <sprite name="res ice"> + <sprite name="res bottles"> + <sprite name="res vodka-barrel"> <sprite name="ui arr sm right"> <sprite name="res cordials">\n<sprite name="res labels"> + <sprite name="res grape-juice"> + <sprite name="res ice"> + <sprite name="res bottles"> + <sprite name="res alcohol-btl"> <sprite name="ui arr sm right"> <sprite name="res cordials"></b>\n\n<b>必要条件:</b>\n<sprite name="skill cordials"><link="cordial-making">リキュール製造</link>、<sprite name="res cash">7500、<sprite name="res barrels">50、<sprite name="res pipes">20、<sprite name="res lumber">20</indent>\n\n設置され、<link="labels">偽造ラベル</link>、<link="fruit-other">果物</link>、<link="ice">氷</link>、<link="bottles">瓶</link>、<link="vodka-barrels">ウォッカ樽</link>が供給されると、この作業場は<link="cordials">リキュール</link>を生産し、市内のビジネスや自社の施設で販売することができます。"
info.production-gin.name	ジン製造
info.production-gin.desc	"<indent=10>ラベル、オーク樽、柑橘類、バスタブジンまたはスパイスと中性アルコールからジンを作ります。\n<b><sprite name="res labels"> + <sprite name="res oak-barrels"> + <sprite name="res citrus"> + <sprite name="res bathtub-gin">\n<sprite name="res labels"> + <sprite name="res spices"> + <sprite name="res citrus"> + <sprite name="res small-bottles"> + <sprite name="res alcohol-btl"></b>\n\n<b>必要条件:</b>\n<sprite name="skill gin"><link="gin-making">本格ジン製造</link>、<sprite name="res cash">7500、<sprite name="res labels">50、<sprite name="res pipes">20、<sprite name="res lumber">20</indent>\n\n設置され、<link="labels">偽造ラベル</link>、<link="oak-barrels">オーク樽</link>、<link="citrus">柑橘類</link>、<link="bathtub-gin">バスタブジン</link>が供給されると、この作業場は<link="gin">ジン</link>を生産し、市内のビジネスや自社の施設で販売することができます。"
info.gambling-den.name	賭博場
info.gambling-den.desc	<indent=10>住宅建物の一角に設けられたギャンブル専用スペースに、思い思いの出し物を設置する。\n\n<b>必要なもの：</b>\n<sprite name="res cash">1200</indent>\n\n賭博場を手に入れたらそのスペースにさまざまな出し物を置いて、客を呼び込むことで収益（現金か債権）を生むことができる。\n\n<i><indent=30><i>勝ち札を持っているときは、常にフェアなプレーを心がけなければならない。</i></indent>\n<indent=40>ーオスカー・ワイルド</indent>
info.casino.name	カジノ
info.casino.desc	<b>一部の都市でのみ利用可能な事業</b>\n\n<indent=10>アトランティックシティの高級住宅街に位置し、様々なゲームや出し物を備えています。\n\n<b>必要なもの：</b>\n<sprite name="skill gambling"><link="gambling-clean-money">資金洗浄</link>、<sprite name="res cash">2500</indent>\n\nカジノのための居住空間を忠実なフロント・オーナーから手に入れたら、客から金を吸い上げるためにピンからキリまで様々な賭け金の出し物を設置する。\n\n<i><indent=30><i>勝ち札を持っているときは、常にフェアなプレーを心がけなければならない。</i></indent>\n<indent=40>ーオスカー・ワイルド</indent>
info.homemade-booze.icon	<sprite name="res cat booze">
info.homemade-booze.name	自家製酒
info.homemade-booze.desc	"<indent=10>壺で作られた基本的な自家製アルコール</indent>\n\n基本的で広く入手可能な材料から、<link="crocks">壺</link>や<link="small-bottles">小瓶</link>で作られるシンプルなアルコール飲料です。これらは市内の他のビジネスに販売できるほか、<link="backroom-bootlegger">密造酒場</link>や<link="corner-speakeasy">街角のスピークイージー</link>で自ら販売することも可能です。また、より収益性の高い<link="refined-booze">精製酒</link>の原材料としても使用できます。\n\n<indent=10><b>自家製酒の種類:</b>\n<sprite name="res brick-wine"> <link="homebooze-brick-wine">ブリックワイン</link>\n<sprite name="res cider"> <link="cider">ハードサイダー</link>\n<sprite name="res home-brew"> <link="home-brew">自家製ビール</link>\n<sprite name="res moonshine"> <link="moonshine">ムーンシャイン</link>\n<sprite name="res apple-jack"> <link="applejack">アップルジャック</link> <i>(地域限定)</i>\n<sprite name="res fruit-wine"> <link="fruit-wine">フルーツワイン</link> <i>(地域限定)</i>\n\n<i><indent=30>「老酒飲みは老医者より多い。」</i></indent>\n<indent=40>—ラブレー</indent>"
info.refined-booze.icon	<sprite name="module produce general">
info.refined-booze.name	醸造酒
info.refined-booze.desc	"<indent=10>さらに加工され、より利益を得るための自家製酒</indent>\n\nこれらのより複雑な種類の酒は、<link="homemade-booze">自家製酒</link>と他の材料を組み合わせ、<link="bottles">瓶</link>や<link="small-bottles">小瓶</link>に詰めることで作られます。これらの酒は、他のビジネスに販売できるほか、組織の<link="corner-speakeasy">街角のスピークイージー</link>やサパークラブで販売することも可能です。適切なスキルを習得すれば、自家製酒ではなく原材料から直接精製酒を生産するようにアップグレードすることもできます。\n\n<indent=10><b>精製酒の種類:</b>\n<sprite name="res fake-wine"><link="fake-wine">偽造ワイン</link>\n<sprite name="res sparkling-cider"><link="sparkling-cider">スパークリングサイダー</link>\n<sprite name="res fake-beer"><link="fake-beer">密造ビール</link>\n<sprite name="res bathtub-gin"><link="bathtub-gin">バスタブジン</link>\n<sprite name="res rakija"><link="rakija">ラキア</link> <i>(地域限定)</i>\n<sprite name="res corn whiskey"><link="corn-whiskey">コーンウィスキー</link> <i>(地域限定)</i></indent>\n\n<indent=30><i>「節制とは、良いものを控えめに、悪いものは完全に断つことである。」</i></indent>\n<indent=40>—フランシス・E・ウィラード</indent>"
info.brick-wine-making.icon	<sprite name="skill brick-wine">
info.brick-wine-making.name	ブリックワイン製造
info.brick-wine-making.desc	このスキルを習得すると、あなたの組織が管理する建物において、<link="homebooze-brick-wine">密造ブリックワイン事業</link>を<b>建設</b>できるようになります。<sprite name="res brick-wine"> <link="brick-wine">ブリックワイン</link>の基本を学べば、<sprite name="res jugs"> <link="crocks">陶器の壺</link>と、小さな樽に入った<sprite name="res grape-juice"> <link="grape-juice">ブドウ濃縮液</link>を使って、ブリックワインを作ることができるようになります。\n\n<indent=30><i>「労働とは、AがBのために財産を得る過程の一つである。」</i></indent>\n<indent=40>— アンブローズ・ビアス</indent>
info.cider-making.icon	<sprite name="skill cider">
info.cider-making.name	シードル製造
info.cider-making.desc	このスキルを習得すると、あなたの組織が管理する建物において、<link="homebooze-cider">密造シードル事業</link>を<b>建設</b>できるようになります。シードル作りについて学ぶと、<sprite name="res jugs"> <link="crocks">陶器の壺</link>を使って、小さな樽に入った<sprite name="res apple-juice"> <link="apple-juice">リンゴジュース</link>を<sprite name="res cider"> <link="cider">ハードシードル</link>に変えることができるようになります。\n\n<indent=30><i>「未来に真実を告げさせ、それぞれの人をその仕事と成果に基づいて評価させる。現在は彼らのものだが、私が本当に働いているのは未来であり、それは私のものだ。」</i></indent>\n<indent=40>—ニコラ・テスラ</indent>
info.home-brew-making.icon	<sprite name="skill home-brew">
info.home-brew-making.name	自家製ビール製造
info.home-brew-making.desc	このスキルを習得すると、あなたの組織が管理する建物に<b>密造自家製ビール事業</b>を<link="homebooze-home-brew">設置</link>できるようになります。<sprite name="res home-brew"><link="home-brew">自家製ビール</link>の作り方を学ぶと、<sprite name="res jugs"><link="crocks">陶器の壺</link>と<sprite name="res malt"><link="malt">麦芽シロップ</link>の容器を使って、自家製ビールを作ることができるようになります。\n\n<indent=30><i>すべての仕事の目的は、生産か成果にある。これを達成するためには、計画性、システム、知恵、正直な目的、そして汗が必要だ。</i> </indent>\n<indent=40>—トーマス・エジソン</indent>
info.moonshine-making.icon	<sprite name="skill moonshine">
info.moonshine-making.name	ムーンシャイン製造
info.moonshine-making.desc	このスキルを習得すると、あなたの組織が管理する建物に<b>密造ムーンシャイン事業</b>を<link="homebooze-moonshine">設置</link>できるようになります。このスキルを学ぶと、<sprite name="res jugs"><link="crocks">陶器の壺</link>を使って、<sprite name="res alcohol-btl"><link="neutral-alcohol">ニュートラルアルコール</link>を<sprite name="res moonshine"><link="moonshine">ムーンシャイン</link>に変換できるようになります。\n\n<indent=30><i>すでに達成されたことには気づかれないが、残されていることだけが目に入る。</i> </indent>\n<indent=40>—マリー・キュリー</indent>
info.brick-wine-making-upgrade.icon	<sprite name="skill brick-wine-upgrade">
info.brick-wine-making-upgrade.name	ブリックワイン増産
info.brick-wine-making-upgrade.desc	このスキルを習得すると、既存の<link="homebooze-brick-wine">ワイン密造所</link> を拡張ワイン密造所に<b>アップグレード</b>することができるようになる。アップグレードすると、<sprite name="res brick-wine"><link="brick-wine">ブリックワイン</link>の生産量が50%増加する。\n\n<indent=30><i>カナダのヤバい連中と取引するのか？カナダが何番街にあるかも知らないのに。</i>\n</indent><indent=40>—アル・カポネ</indent>
info.cider-making-upgrade.icon	<sprite name="skill cider-upgrade">
info.cider-making-upgrade.name	圧縮技法
info.cider-making-upgrade.desc	このスキルを習得すると、既存の<link="homebooze-cider"><b>密造シードル事業</b></link>を拡張されたシードル事業に<b>アップグレード</b>することができます。アップグレードされると、<sprite name="res cider"><link="cider">ハードシードル</link>の生産量が50%増加します。\n\n<indent=30><i>罰されない罪は決して後悔されない。我々は過ちそのものではなく、その結果に泣くのだ。</i> </indent>\n<indent=40>—レティシア・エリザベス・ランドン</indent>
info.home-brew-making-upgrade.icon	<sprite name="ui skills">
info.home-brew-making-upgrade.name	もっとたくさんのモルト
info.home-brew-making-upgrade.desc	このスキルを習得すると、既存の<link="homebooze-home-brew"><b>自家製ビール事業</b></link>を拡張された自家製ビール事業に<b>アップグレード</b>することができます。アップグレードされると、<sprite name="res home-brew"><link="home-brew">自家製ビール</link>の生産量が50%増加します。\n\n<indent=30><i>都市は人類の奈落である。</i> </indent>\n<indent=40>—ジャン＝ジャック・ルソー</indent>
info.moonshine-making-upgrade.icon	<sprite name="skill moonshine-upgrade">
info.moonshine-making-upgrade.name	追加抽出
info.moonshine-making-upgrade.desc	このスキルを習得すると、既存の<link="homebooze-moonshine"><b>密造ムーンシャイン事業</b></link>を拡張されたムーンシャイン事業に<b>アップグレード</b>することができます。アップグレードされると、<sprite name="res moonshine"><link="moonshine">ムーンシャインの生産量</link>が50%増加します。\n\n<indent=30><i>私が酒を売ると、それは密造と呼ばれる。でも私の客がそれを銀のトレイでレイクショア・ドライブで出すと、それはホスピタリティと呼ばれるんだ。</i> </indent>\n<indent=40>—アル・カポネ</indent>
info.fake-wine-skill.icon	<sprite name="skill fake-wine">
info.fake-wine-skill.name	密造ワイン製造
info.fake-wine-skill.desc	このスキルにより、より収益性の高い<sprite name="res fake-wine"> <link="fake-wine">偽造ワイン</link>のボトルを作成し、流通を拡大することができるようになる。\nこのスキルを取得すると、自分の組織が管理する建物の中に<link="production-fake-wine">密造ワイン製造所</link>を<b>建設</b>することができるようになります。\n<indent=30><i>労働， n. AがBのために財産を取得する過程の一つ。</i></indent>\n<indent=40>アンブローズ・ビアス</indent>
info.sparkling-cider-skill.icon	<sprite name="skill sparkling-cider">
info.sparkling-cider-skill.name	スパークリングシードル (スキル)
info.sparkling-cider-skill.desc	このスキルを習得すると、<sprite name="res cider"><link="cider">シードル</link>に炭酸を加えることができるようになります。炭酸が入っていると、人々はもっと高く支払ってくれます。このスキルを習得すると、組織が管理する建物内に<link="production-sparkling-cider"><b>スパークリングシードル事業</b></link>を<b>設置</b>できるようになります。\n\n<indent=30><i>未来が真実を語り、それぞれの仕事や成果に基づいて評価するだろう。現在は彼らのものだが、私が本当に働いたのは未来のためだ。</i> </indent>\n<indent=40>—ニコラ・テスラ</indent>
info.fake-beer-skill.icon	<sprite name="skill fake-beer">
info.fake-beer-skill.name	密造ビール醸造
info.fake-beer-skill.desc	このスキルを習得すると、<sprite name="res home-brew"><link="home-brew">自家製ビール</link>を、より本物に近いものに仕上げることができます。このスキルを習得すると、組織が管理する建物内に<link="production-fake-beer"><b>密造ビール事業</b></link>を<b>設置</b>できるようになります。\n\n<indent=30><i>都市は人類の奈落である。</i> </indent>\n<indent=40>—ジャン＝ジャック・ルソー</indent>
info.bathtub-gin-skill.icon	<sprite name="skill bathtub-gin">
info.bathtub-gin-skill.name	バスタブ・ジン製造
info.bathtub-gin-skill.desc	<sprite name="res moonshine"><link="moonshine">ムーンシャイン</link>を薄めたり改造したりして、カクテルシェイカーにふさわしいものに変える方法を学びましょう。このスキルを習得すると、組織が管理する建物内に<link="production-bathtub-gin"><b>バスタブジン事業</b></link>を<b>設置</b>できるようになります。\n\n<indent=30><i>私が酒を売ると密売と呼ばれる。私の客がシルバートレイに載せて提供すると、ホスピタリティと呼ばれるのさ。</i></indent> \n<indent=40>—アル・カポネ</indent>
info.apple-press.icon	<sprite name="skill apple-press">
info.apple-press.name	りんご圧搾
info.apple-press.desc	<sprite name="res apples"><link="apples">リンゴ</link>をジュースに変える方法を学び、<sprite name="res apple-juice"><link="apple-juice">リンゴジュース</link>をより安価に、大規模かつ工業的なスケールで作れるようにしましょう。このスキルを習得すると、組織が管理する建物内に<link="conversion-apple-juice"><b>リンゴジュース圧搾機</b></link>を<b>設置</b>できるようになります。\n\n<indent=30><i>確かに、リンゴは果物の中で最も高貴な存在だ。</i></indent>\n <indent=40>—ヘンリー・デイヴィッド・ソロー</indent>
info.grape-press.icon	<sprite name="skill grape-press">
info.grape-press.name	ブドウ圧搾
info.grape-press.desc	<sprite name="res grapes"> <link="grapes">ブドウ</link>を <sprite name="res grape-juice"> <link="grape-juice">ブドウ濃縮物</link>に変える方法を学ぶことで<link="brick-wine">ブリックワイン</link>をより安く大量生産できるようになる。\nこのスキルを取得すると、自分の組織が管理する建物に<link="conversion-grape-juice">ブドウ圧搾機</link>を<b>設置</b>することができるようになる。\n\n<i><indent=30><i>青いブドウに焦がれるな</i></indent>\n<indent=40>—ホラティウス</indent>
info.malt-making.icon	<sprite name="skill malt-making">
info.malt-making.name	モルト製造
info.malt-making.desc	<sprite name="res barley"><link="barley">大麦</link>を<sprite name="res malt"><link="malt">麦芽シロップ</link>に変えて、ビール製造のための供給を確保する方法を学びましょう。このスキルを習得すると、組織が管理する建物内に<link="conversion-malt"><b>麦芽加工機</b></link>を<b>設置</b>できるようになります。\n\n<indent=30><i>深く根ざした嗜好は論じることはできない——人にビールを好きになるよう説得することはできないのだ。</i></indent>\n<indent=40>—オリバー・ウェンデル・ホームズ</indent>
info.backroom-distillation.icon	<sprite name="skill backroom-distillation">
info.backroom-distillation.name	その場しのぎの蒸留器
info.backroom-distillation.desc	このスキルを習得すると、安価で手に入りやすい<sprite name="res corn-syrup"><link="corn-syrup">コーンシロップ</link>から<sprite name="res alcohol-btl"><link="neutral-alcohol">中性アルコール</link>を製造できるようになります。このスキルを習得すると、組織が管理する建物内に<link="conversion-neutral-alcohol"><b>密造基本蒸留所</b></link>を<b>設置</b>できるようになります。\n\n<indent=30><i>神よ、私を金床に置き、打ち叩いてバールに鍛えてください。古い壁をこじ開け、古い基礎を持ち上げて緩めることができるように。</i></indent>\n <indent=40>—カール・サンドバーグ</indent>
info.applejack-making.icon	<sprite name="skill applejacking">
info.applejack-making.name	アップルジャック製造
info.applejack-making.desc	<b>地域限定スキル。特定の都市でのみ使用可能。</b>\n\n<sprite name="res ice"><link="ice">氷</link>を使って、<sprite name="res apples"><link="apples">リンゴ</link>や<sprite name="res apple-juice"><link="apple-juice">リンゴジュース</link>を<sprite name="res apple-jack"><link="applejack">アップルジャック</link>に変換する方法を学びます。このスキルを習得すると、組織が管理する建物内に<b>密造アップルジャック事業</b>を<b>設置</b>できるようになります。\n\n<indent=30><i>この奇妙な変容の奇跡とは何か、霜と光の野生の働き、この無限の栄光の一瞥。</i></indent> \n<indent=40>—ジョン・グリーンリーフ・ホイッティア</indent>
info.moonshine-distillation.icon	<sprite name="skill moonshine">
info.moonshine-distillation.name	ムーンシャイン醸造
info.moonshine-distillation.desc	<b>地域限定スキル。特定の都市でのみ使用可能。</b>\n\n<sprite name="res corn"><link="corn">トウモロコシ</link>と<sprite name="res steel-barrels"><link="steel-barrels">鉄樽</link>を使用して<sprite name="res moonshine"><link="moonshine">ムーンシャイン</link>を蒸留する方法を学びます。このスキルを習得すると、組織が管理する建物内に<b>密造ムーンシャイン蒸留所</b>を<b>設置</b>できるようになります。\n\n<indent=30><i>熱いウイスキーをぐっと一杯寝る前に飲む — 科学的ではないが、効果はある。</i></indent>\n <indent=40>—アレクサンダー・フレミング</indent>
info.fruit-brandy-skill.icon	<sprite name="skill fruit brandy">
info.fruit-brandy-skill.name	プラムブランデー
info.fruit-brandy-skill.desc	<b>地域限定スキル。特定の都市でのみ使用可能。</b>\n\nこのスキルを習得すると、<sprite name="res plums"><link="plums">プラム</link>を発酵させ、その後蒸留して強力なアルコール飲料である<sprite name="res rakija"><link="rakija">ラキヤ</link>を作ることができます。クルーがこのスキルを習得すると、組織が管理する建物内に<b>ラキヤ蒸留所</b>を<b>設置</b>できるようになります。\n\n<indent=30>Πολλὰ μεταξὺ πέλει κύλικος καὶ χείλεος ἄκρου。（カップと口の間には多くのことが起こりうる）</indent> \n<indent=40>—ギリシャのことわざ</indent>
info.corn-whiskey-skill.icon	<sprite name="skill whiskey-bottled">
info.corn-whiskey-skill.name	コーンウイスキー製造
info.corn-whiskey-skill.desc	<b>地域限定スキル。特定の都市でのみ使用可能。</b>\n\nこのスキルを習得すると、<sprite name="res corn"><link="corn">トウモロコシ</link>を使って、需要がある都市で<sprite name="res corn whiskey"><link="corn-whiskey">コーンウィスキー</link>を作ることができます。クルーがこのスキルを習得すると、<b>コーンウィスキー蒸留所</b>を<b>設置</b>できるようになります。\n\n<indent=30><i>ウィスキーが治せないものは、治ることがない。</i></indent>\n <indent=40>—アイルランドのことわざ</indent>
info.bourbon-sources.icon	<sprite name="skill whiskey-bottled">
info.bourbon-sources.name	バーボンの需要
info.bourbon-sources.desc	<b>一部の都市でのみ利用可能な事業</b>\n\n誰かからこのスキルを獲得すれば、バーボンを消費する事業が明らかとなる。\n\n<indent=30><i>私は今まで生きてきた中で銃、カードの束、そしてウイスキーの容器を持っていない人間を見たことがない。</i></indent>\n<indent=40>アンドリュー・ジャクソン</indent>
info.bourbon-making.icon	<sprite name="skill whiskey-bottled">
info.bourbon-making.name	バーボンの偽造
info.bourbon-making.desc	<b>地域限定スキル。特定の都市でのみ使用可能。</b>\n\nケンタッキー州出身者と親しくなれば、彼らに<sprite name="res bourbon"><link="bourbon">バーボン</link>の偽物作りの方法を教えてもらえるかもしれません。この知識を得ることで、クルーが管理する建物に<b>バーボン瓶詰事業</b>を<b>設置</b>できるようになります。\n\n<indent=30><i>常にウィスキーを持ち歩け。ヘビに噛まれたときのためだ。そして小さなヘビも一緒に持ち歩け。</i></indent>\n <indent=40>—W.C. フィールズ</indent>
info.barrel-aging.icon	<sprite name="skill whiskey-still">
info.barrel-aging.name	樽熟成
info.barrel-aging.desc	<b>地域限定スキル。特定の都市でのみ使用可能。</b>\n\nこのスキルを習得すると、<sprite name="res whiskey-barrel">ウィスキーバレルを<sprite name="res corn">トウモロコシから製造できるようになります。クルーがこのスキルを習得すれば、トウモロコシ・ウィスキー蒸留所を<b>アップグレード</b>して、ボトル入りのトウモロコシ・ウィスキーに加えて、ウィスキーバレルを生産できるようになります。\n\n<indent=30><i>穀物がないとき、それは都市に対する復讐の兆候である。</i></indent> \n<indent=40>—シュメールの格言</indent>
info.sanitary-measures.icon	<sprite name="skill expansions">
info.sanitary-measures.name	衛生対策
info.sanitary-measures.desc	アルコール製造事業を可能な限り無菌で清潔に保つことは、生産量の向上につながります。このスキルを習得すると、製造事業に<b>スチーム・サニタイザー</b>拡張を追加できるようになります。\n\n<indent=30><i>洗い流せばすべて明らかになる。</i></indent>\n <indent=40>—ミゲル・デ・セルバンテス</indent>
info.industrial-filters.icon	<sprite name="skill expansions">
info.industrial-filters.name	産業用フィルター
info.industrial-filters.desc	不要なゴミ、原材料の加工過程で生じた残留物やその他の残渣は、発酵や蒸留の前に蓄積し、最終的な製品に影響を与えることがあります。この問題に対処するため、このスキルを習得すると、<b>インダストリアル・フィルター</b>拡張を事業に追加し、各バッチの原材料からの収量を増やすことができるようになります。\n\n<indent=30><i>産業のない生活は罪、芸術のない産業は野蛮である。</i></indent> \n<indent=40>—ジョン・ラスキン</indent>
info.good-yeast.icon	<sprite name="skill expansions">
info.good-yeast.name	高品質イースト
info.good-yeast.desc	酵母—この勤勉な小さな真菌たち—は、発酵のエンジンです。単純な植物の糖からアルコールを生み出す能力が、酵母を人類にとって最も愛される微生物にしました。高品質の工業用酵母は仕事をより早くこなすので、それを手に入れたら、酒造事業に<b>高品質酵母</b>の拡張を導入し、製造速度を向上させることができます。\n\n<indent=30><i>自然を学べば学ぶほど、創造主の業に驚嘆します。私は実験室で仕事に取り組んでいる間、祈りを捧げます。</i></indent> \n<indent=40>—ルイ・パスツール</indent>
info.trap-door.icon	<sprite name="skill expansions">
info.trap-door.name	落とし戸
info.trap-door.desc	禁酒法時代、酒場の経営者たちは悩みを抱えています。それは、顧客のために十分な酒を手元に置いておく必要がある一方で、もし摘発があった際に警察に過剰な量を押収されないようにすることです。その答えは？秘密の扉です。このスキルを習得することで、密造所やスピークイージーに<b>隠し扉</b>を設置し、1日に販売できる酒の量を増やすことができます。\n\n<indent=30><i>秘密ほど速く広まるものはありません。</i></indent> \n<indent=40>—レティシア・エリザベス・ランダン</indent>
info.printed-promotions.icon	<sprite name="skill expansions">
info.printed-promotions.name	印刷物による宣伝
info.printed-promotions.desc	印刷師や印刷物を大量に消費する人と友達になったことがありますか？印刷のイロハを教えてもらえば、それを生かすことができます。このスキルを取得すると、自分が管理する潜り酒場に<b>印刷広告</b>の新しい技術を導入し、1日に販売する酒量を増やすことができるようになります。\n\n<indent=30><i>たとえ天使が書くべきものであっても、悪魔が印刷しなければならないのだ。</i></indent>\n<indent=40>トーマス・ムーア</indent>。
info.bootleg-whiskey.icon	<sprite name="skill whiskey-bottled">
info.bootleg-whiskey.name	ブートレッグウイスキー
info.bootleg-whiskey.desc	<sprite name="res whisky"> <link="whiskey-bottled">ウィスキー</link>のように見えるものを作る方法を学びましょう。あなたもそれが本物ではないことは分かっていますし、顧客もそれが本物ではないことに気づくでしょう。しかし、これは切迫した時代の中でのことです。\n\nこのスキルを習得することで、あなたの組織が管理する建物に<b>即席ウィスキー蒸留所</b>を建設できるようになります。\n\n<indent=30><i>成功の欠如に戸惑い、悩んだ誘惑者は立ち尽くし、欺瞞が暴かれ、希望から投げ出され、返す言葉もなかった。</i></indent> \n<indent=40>—ジョン・ミルトン</indent>
info.bootleg-vodka.icon	<sprite name="skill vodka-bottled">
info.bootleg-vodka.name	ブートレグウォッカ
info.bootleg-vodka.desc	<sprite name="res vodka"> <link="vodka-bottled">ウォッカ</link>のように見えるものを作る方法を学びましょう。あなたもそれが本物ではないことは分かっていますし、顧客もそれが本物ではないことに気づくでしょう。しかし、これは切迫した時代の中でのことです。\n\nこのスキルを習得することで、あなたの組織が管理する建物に<b>即席ウォッカ蒸留所</b>を建設できるようになります。\n\n<indent=30><i>結局のところ、嘘とは何か？それは仮面をかぶった真実にすぎない。</i></indent> \n<indent=40>—ロード・バイロン</indent>
info.bootleg-brandy.icon	<sprite name="skill brandy-bottled">
info.bootleg-brandy.name	ブートレグブランデー
info.bootleg-brandy.desc	<sprite name="res brandy"> <link="brandy-bottled">ブランデー</link>のように見えるものを作る方法を学びましょう。あなたもそれが本物ではないことは分かっていますし、顧客もそれが本物ではないことに気づくでしょう。しかし、これは切迫した時代の中でのことです。\n\nこのスキルを習得することで、あなたの組織が管理する建物に<b>即席ブランデー蒸留所</b>を建設できるようになります。\n\n<indent=30><i>失敗に困惑し、戸惑いながら誘惑者は立ち尽くした。彼の詐欺が露見し、希望が消え去ったのを見たのだ。</i></indent>\n<indent=40>—ジョン・ミルトン</indent>
info.bootleg-rum.icon	<sprite name="skill rum-bottled">
info.bootleg-rum.name	ブートレグラム
info.bootleg-rum.desc	<sprite name="res rum"> <link="rum-bottled">ラム酒</link>のように見えるものを作る方法を学びましょう。あなたもそれが本物ではないことは分かっていますし、顧客もそれが本物ではないことに気づくでしょう。しかし、これは切迫した時代の中でのことです。\n\nこのスキルを習得することで、あなたの組織が管理する建物に<b>即席ラム酒蒸留所</b>を建設できるようになります。\n\n<indent=30><i>そして結局、嘘とは何だ？それはただ、仮面を被った真実に過ぎない。</i></indent> \n<indent=40>—ロード・バイロン</indent>
info.whiskey-still.icon	<sprite name="skill whiskey-still">
info.whiskey-still.name	ウイスキー用小型蒸留器
info.whiskey-still.desc	<sprite name="res whiskey-barrel"> <link="whiskey-barrel">ウイスキー樽</link>を製造するための本格的なウイスキー蒸留所を建設する方法を学びましょう。\n\nこのスキルを習得することで、あなたの組織が管理する建物に<b>小型ウイスキー蒸留所</b>を建設できるようになります。\n\n<indent=30><i>グラスにウイスキーが注がれる軽やかな音楽が、心地よい間奏曲となった。</i></indent>\n<indent=40>—ジェームズ・ジョイス</indent>
info.brandy-still.icon	<sprite name="skill brandy-still">
info.brandy-still.name	小型ブランデー蒸留機
info.brandy-still.desc	<sprite name="res brandy-barrel"> <link="brandy-barrel">ブランデー樽</link>を製造するための本格的なブランデー蒸留所を建設する方法を学びましょう。\n\nこのスキルを習得することで、あなたの組織が管理する建物に<b>小型ブランデー蒸留所</b>を建設できるようになります。\n\n<indent=30><i>彼はもう一口ブランデーを飲み、まるで最悪の事態を覚悟しているかのように大きな金髪の頭を振った。</i></indent> \n<indent=40>—ロバート・ルイス・スティーブンソン</indent>
info.rum-still.icon	<sprite name="skill rum-still">
info.rum-still.name	小型ラム酒蒸留器
info.rum-still.desc	<sprite name="res barrel-rum"> <link="rum-barrel">ラム樽</link>を製造するための本格的なラム蒸留所を建設する方法を学びましょう。\n\nこのスキルを習得することで、あなたの組織が管理する建物に<b>小型ラム蒸留所</b>を建設できるようになります。\n\n<indent=30><i>全ての道はラムに通ず。</i></indent> \n<indent=40>—W.C. フィールズ</indent>
info.vodka-still.icon	<sprite name="skill vodka-still">
info.vodka-still.name	小型ウォッカ蒸留器
info.vodka-still.desc	<sprite name="res vodka-barrel"> <link="vodka-barrel">ウォッカ樽</link>を製造するための本格的なウォッカ蒸留所を建設する方法を学びましょう。\n\nこのスキルを習得することで、あなたの組織が管理する建物に<b>小型ウォッカ蒸留所</b>を建設できるようになります。\n\n<indent=30><i>葉巻やウォッカのグラスを一杯飲んだ後...自我が二つに割れる。第三者の視点で自分を見始めるのだ。</i></indent> \n<indent=40>—アントン・チェーホフ</indent>
info.booze-bottling.icon	<sprite name="skill booze-bottling">
info.booze-bottling.name	酒の瓶詰め
info.booze-bottling.desc	酒を <sprite name="res bottles"> <link="bottles">瓶</link>に詰め、<sprite name="res labels"> <link="labels">ラベル</link>を貼り付ける方法を学びましょう。\n\nこのスキルを習得することで、あなたの組織が管理する建物に<b>小規模ボトリング事業</b>を建設できるようになります。\n\n<indent=30><i>夜になると、高層ビルは煙と星の中にそびえ立ち、魂を持つ。</i></indent> \n<indent=40>—カール・サンドバーグ</indent>
info.backroom-bootlegging.icon	<sprite name="skill backroom-bootlegging">
info.backroom-bootlegging.name	密造酒密売店
info.backroom-bootlegging.desc	このスキルを習得すれば、中間業者を排除し、少量の自家製酒を直接、喉の渇いた顧客に売ることができます。\n\nこのスキルを習得することで、あなたの組織が管理する建物に<b><link="backroom-bootlegger">密造酒事業</link></b>を建設できるようになります。\n\n<indent=30><i>60日なんて、自由に過ごせるならあっという間だろう。でも、酒のない牢屋なんて、ただの地獄だ。酒がないと、人生なんてただの苦しみさ。</i></indent>\n<indent=40>—マ・レイニー</indent>
info.local-speakeasies.icon	<sprite name="skill speakeasy">
info.local-speakeasies.name	角の潜り酒場
info.local-speakeasies.desc	あなたの密造酒事業を拡張して、すべての種類の自家製酒、さらにはいくつかの特別な商品も販売できるフルスピークイージーにアップグレードしましょう。\n\nこのスキルを習得することで、あなたの組織が管理する建物に<b><link="corner-speakeasy">街角のスピークイージー</link></b>を建設できるようになり、あるいは既存の密造酒事業を<b>アップグレード</b>して拡張することが可能になります。\n\n<indent=30><i>スピークイージーは酒場に取って代わり、膨大な数の法律違反者が現れた。多くの我々の優れた市民が禁酒法を公然と無視している。</i></indent> \n<indent=40>—ジョン・D・ロックフェラー</indent>
info.small-speakeasy-skill.icon	<sprite name="skill speakeasy">
info.small-speakeasy-skill.name	簡単な話
info.small-speakeasy-skill.desc	スピークイージーを拡張して、多様な種類の酒類を販売しましょう。\n\nこのスキルを習得し、小規模なスピークイージーを建設するか、街角のスピークイージーを拡張することで、ウイスキー、ブランデー、ラム、ウォッカなどを地元の顧客に直接販売することが可能になります。\n\n<indent=30><i>スピークイージーは酒場に取って代わり、膨大な数の法律違反者が現れた。多くの我々の優れた市民が禁酒法を公然と無視している。</i></indent>\n <indent=40>—ジョン・D・ロックフェラー</indent>
info.supper-clubs.icon	<sprite name="skill supper-club">
info.supper-clubs.name	サパークラブ
info.supper-clubs.desc	18条改正が可決された後、サパークラブが急速に広がりました。これらのプライベートクラブは、人々が集まり、食事（そして飲酒）をしながら、当局の目を逃れるための人気の場となりました。\n\nこのスキルを習得すると、あなたの組織が支配する建物に<i>サパークラブ</i>を建設することができます。\n\n<indent=30><i>お前の家が寂しく見えないか？　赤ん坊が荷物をまとめて去ってしまった時。ムーンシャインを飲んでごまかしても、心は自由じゃないぜ。</i></indent>\n <indent=40>—ブラインド・レモン・ジェファーソン</indent>
info.large-clubs.icon	<sprite name="skill expanded-venues">
info.large-clubs.name	広大な会場
info.large-clubs.desc	自らの手で最高のエンターテイメント施設を開業し、究極の名声を手に入れましょう。ダンスホール？ジャズクラブ？高級レストラン？何を選んでも、きっとその街の一番のスポットになるでしょう。\n\n<indent=30><i>ブルースのミュージシャンは引退しない。倒れるだけだ。</i></indent> \n<indent=40>—バディ・ガイ</indent>\n\n
info.upgraded-bootlegging.icon	<sprite name="skill upgraded-bootlegging">
info.upgraded-bootlegging.name	拡張した密売
info.upgraded-bootlegging.desc	Acquiring this skill allows you to upgrade a <link="backroom-bootlegger">backroom bootlegging operation</link> to sell more than one type of <link="homemade-booze">homemade booze</link>. Once upgraded， it will also sell more of the type of homemade booze that it was initially built to sell.\n\n<indent=30><i>I saw you last evening standin' up against a tree; I heard you say you were sick but you looked sloppy drunk to me.</i></indent>\n<indent=40>—Lucille Bogan from "Sloppy Drunk Blues"</indent>
info.superior-stills.icon	<sprite name="skill moonshine-upgrade">
info.superior-stills.name	高性能な蒸留器
info.superior-stills.desc	<b>このスキルは特定の都市でのみ利用可能です。</b>\n\nこのスキルを習得すると、既存の密造ムーンシャイン蒸留所を<b>拡張ムーンシャイン蒸留所</b>にアップグレードすることができます。アップグレード後、<sprite name="res moonshine"> <link="moonshine">ムーンシャイン生産量</link>が50%増加します。\n\n<indent=30><i>私が酒を売れば、それは密造と呼ばれる。だが、私の顧客がシカゴのレイクショア・ドライブで銀のトレイに乗せて酒を提供すれば、それはもてなしと呼ばれる。</i></indent> \n<indent=40>—アル・カポネ</indent>
info.fruitful-operations.icon	<sprite name="skill fruit-wine">
info.fruitful-operations.name	フルーツワイン製造所
info.fruitful-operations.desc	<b>このスキルは特定の都市でのみ利用可能です。</b>\n\nこのスキルをクルーが習得すると、密造果実酒事業を自分の組織が管理する建物に設立できるようになります。これを設立すれば、<sprite name="res fruit-wine"> <link="fruit-wine">果実酒</link>を、<sprite name="res small-bottles"> <link="small-bottles">小瓶</link>に詰め、<sprite name="res fruit"> <link="fruit-other">果物</link>と<sprite name="res sugar"> <link="sugar">砂糖</link>を混ぜて発酵させることで製造することが可能になります。\n\n<indent=30><i>サクランボやイチゴの味を知るには、子供や鳥に聞かなければならない。</i></indent>\n <indent=40>—ヨハン・ヴォルフガング・フォン・ゲーテ</indent>
info.champagne-making.icon	<sprite name="skill champagne">
info.champagne-making.name	シャンパーニュ方式
info.champagne-making.desc	このスキルにより自分の組織が管理する建物にシャンパン製造所を建設することができます。お酒に華やかさと泡を添える方法を習得します。シャンパン製造所では、<sprite name="res fake-wine"><link="fake-wine">偽造ワイン</link>の在庫品と<sprite name="res ice"><link="ice">氷</link>、<sprite name="res sugar"><link="sugar">砂糖</link>を使って酒を造り、そのボトルに<sprite name="res labels"><link="labels">偽造ラベル</link>を貼り付けることで<sprite name="res champagne"><link="champagne">シャンパン</link>とします。\n\n<indent=30><i>シャンパンは人生の優雅な余興のひとつ</i></indent>。\n<indent=40>-チャールズ・ディケンズ</indent>。
info.dark-rum-making.icon	<sprite name="skill dark-rum">
info.dark-rum-making.name	スパイス入りラム酒製造
info.dark-rum-making.desc	このスキルを習得すると、あなたの組織が管理する建物にスパイス入りラム酒製造施設（Spiced Rum Manufacture）を設置できるようになります。\n\n通常のラム酒も悪くありませんが、スパイス入りラム酒は独特の風味と個性があります。この施設を稼働させることで、<sprite name="res dark rum"> <link="dark-rum">スパイス入りラム酒</link>を<sprite name="res barrel-rum"> <link="rum-barrel">ラム酒の樽</link>から作ることができます。ラム酒を<sprite name="res oak-barrels"> <link="oak-barrels">オーク樽</link>に移し、<sprite name="res spices"> <link="spices">スパイス</link>を加えてしばらく熟成させた後、<sprite name="res bottles"> <link="bottles">ボトル</link>に詰め、最後に<sprite name="res labels"> <link="labels">ラベル</link>を貼って完成です。\n\n<indent=30><i>精神を静めるものとして、ラム酒と真の宗教に勝るものはない。</i></indent>\n <indent=40>—ロード・バイロン</indent>
info.beer-kegs-skill.icon	<sprite name="skill beer-kegs">
info.beer-kegs-skill.name	樽のビール
info.beer-kegs-skill.desc	このスキルを習得すると、あなたの組織はビールを樽で出荷できる「大型醸造所」を設立できるようになります。\n\n瓶ビールは扱いが面倒で、大量生産には向きません。しかし、鋼鉄製の樽に詰めれば、話は変わってきます。やり方は簡単です。必要なのは、<sprite name="res fake-beer"> <link="fake-beer">密造ビール</link>、<sprite name="res ice"> <link="ice">氷</link>、そして<sprite name="res steel-barrels"> <link="steel-barrels">鋼鉄製の樽</link>の供給です。それを組み合わせ、冷却して出荷するだけです！\n\n<i><indent=30><i>根深い好みは議論できないし、ビールが好きな人にそれを変えさせることはできない。</i></indent> \n<indent=40>—オリバー・ウェンデル・ホームズ</indent>
info.aged-whiskey-skill.icon	<sprite name="skill aged-whiskey">
info.aged-whiskey-skill.name	ウイスキーの年代物
info.aged-whiskey-skill.desc	このスキルを習得すると、あなたの組織が管理する建物に「熟成ウィスキー製造所」を設立できるようになります。\n\n新鮮なウィスキーでも酔えますが、熟成ウィスキーは滑らかでオークの風味が加わり、その魅力をさらに引き立てます。作業は非常にシンプルです。<sprite name="res whiskey-barrel"> <link="whiskey-barrel">ウィスキー樽</link>をいくつか<sprite name="res oak-barrels"> <link="oak-barrels">オーク樽</link>に移し、時間に任せて熟成させるだけです。\n\n<indent=30><i>何事も過ぎたるは悪いが、良いウィスキーは多すぎることは決してない。</i></indent>\n <indent=40>—マーク・トウェイン</indent>
info.gin-making.icon	<sprite name="skill gin">
info.gin-making.name	正しいジン
info.gin-making.desc	"ジンの正しい作り方を学び、自分の服が管理する建物の中にジン製造所を建設する。\n\n禁酒法以前の古いジンのレシピを製品化する。瓶詰め前に、<sprite name="res oak-barrels"> <link="oak-barrels"> オーク樽</link>で、<sprite name="res citrus"> <link="citrus"> 柑橘系果実</link>と<sprite name="res spices"> スパイス</link>を使用してアルコールの原型を熟成することが必要だ。\n\n<indent=30><i>芸術のための芸術は、ジンのためのジンより意味がない。</i></indent>\n<indent=40>—W. サマセット・モーム</indent>"
info.cordial-making.icon	<sprite name="skill cordials">
info.cordial-making.name	コーディアルをあなたに
info.cordial-making.desc	"このスキルを習得すると、自分の組織が管理する建物内にある「コーディアル製造所」で、様々な資源からコーディアルを作ることができるようになります。\n\nコーディアルやその他のリキュールは、多くの高級カクテルの重要な材料である。<sprite name="res alcohol-btl"> <link="neutral-alcohol">中性アルコールl</link> や <sprite name="res vodka-barrel"> <link="vodka-barrel">ウォッカの樽</link> をベースにしてコーディアルを作るためのレシピがいくつも公開されている。そして、他の材料で活気を与え、酒場や高級クラブで主役になる準備をする。\n\n<i><indent=30><i>マティーニは、ソネットのように完璧なアメリカの唯一の発明品です。</i></indent>\n<indent=40>—H.L.メンケン</indent>"
info.truck-driving.icon	<sprite name="skill truck-driving">
info.truck-driving.name	トラック運転
info.truck-driving.desc	配送運転について学ぶことで、操作できるトラックの数が増え、すべての車両の摩耗を減らすことができる。\n\nまた、小型トラックの修理ベイも作ることができる。\n\n<i><indent=30>世界的な豚の精肉業者、道具メーカー、小麦の積み出し業者、鉄道事業者と貨物取扱業者、嵐、ハスキー、喧嘩腰、ビッグショルダーの都市。</i></indent>\n<indent=40>—カール・サンドバーグ</indent>
info.small-garages.icon	<sprite name="skill garages">
info.small-garages.name	ガレージ建設
info.small-garages.desc	このスキルを習得すると、自分の管理する建物の1つに小さなガレージを建てることができるようになる。\n\nこのスキルを習得すると、自分の組織が支配している建物に小さなガレージを建てることができるようになる。\n\n<i><indent=30><i>神よ、私を金床（かなとこ）に置いてください。私を叩いて、バールのように叩いてください。古い壁をこじ開けさせてください 古い土台を持ち上げてゆるめさせてください</i></indent>\n<indent=40>—カール・サンドバーグ</indent>
info.truck-garage.icon	<sprite name="skill truck-bays">
info.truck-garage.name	トラック修理ベイ
info.truck-garage.desc	このスキルを習得すると、自分の管理する建物の一つにトラック修理室を作ることができ、対応できるトラックの数を増やすことができる。\n\n<i><indent=30>私は理想主義者です。どこに向かっているのか分からないが、自分の道を進んでいる。</i></indent>\n<indent=40>—カール・サンドバーグ</indent>
info.truck-garage-improved.icon	<sprite name="skill expanded-truck-bays">
info.truck-garage-improved.name	拡張修理ベイ
info.truck-garage-improved.desc	このスキルを習得すると、トラックの修理ベイをアップグレードしてトラックの容量を増やし、トラックの保有台数を増やすことができる。
info.car-bullies.icon	<sprite name="skill general vehicle">
info.car-bullies.name	交渉アシスタント
info.car-bullies.desc	このスキルを習得すると、交渉術が<i>強化</i>され、今後購入する全ての車両に大幅な割引が適用される。\n\n<i><indent=30>私は理想主義者です。どこに向かっているのか分からないが、自分の道を進んでいる。</i></indent>\n<indent=40>—カール・サンドバーグ</indent>
info.dishwashers.icon	<sprite name="skill expansions">
info.dishwashers.name	温水食器洗い機
info.dishwashers.desc	"この技術を習得すれば、<link="backroom-bootlegger">密造酒密売所</link>や<link="corner-speakeasy">潜り酒場</link>で皿洗いの拡張を構築でき、ドリンクを注ぐのにかかる時間を短縮して1日の販売数を増加することができる。\n\n<indent=30><i>酒場に代わってもぐり酒場が登場し、法を犯す大軍が出現し、多くの優秀な市民が公然と禁酒法を無視するようになった。</i></indent>\n<indent=40>—ジョン・D・ロックフェラー</indent>"
info.big-barrels.icon	<sprite name="skill expansions">
info.big-barrels.name	二重樽
info.big-barrels.desc	"このスキルを習得すると、<link="homemade-booze">自家製酒</link>事業で二重樽生産拡張を行うことができ、生産量を増加させることができる。\n\n<i><indent=30><i>根強い嗜好は議論することができない。例えば、ビール一杯が好きな人を論破することはできない。</i></indent>\n<indent=40>—オリバー・ウェンデル・ホームズ</indent>"
info.old-glassware.icon	<sprite name="skill expansions">
info.old-glassware.name	水晶のバー製品
info.old-glassware.desc	"この技術を習得すれば、<link="backroom-bootlegger">密造酒密売店</link>や<link="corner-speakeasy">潜り酒場</link>でアンティークな水晶食器を展開し、多くの消費者を引きつけて一日の収入を増やすことができるようになる。\n\n<indent=30><i>酒場に代わってもぐり酒場ができ、法を犯す巨大な軍隊が出現し、多くの優秀な市民が公然と禁酒法を無視するようになった。</i></indent>\n<indent=40>—ジョン・D・ロックフェラー</indent>"
info.pool-table.icon	<sprite name="skill expansions">
info.pool-table.name	ビリヤードテーブル
info.pool-table.desc	このスキルを習得すると、<link="backroom-bootlegger">密造酒場</link>や<link="corner-speakeasy">街角のスピークイージー</link>にビリヤード台を設置する拡張が可能になり、より多くの客を引き寄せ、日々の収益が増加します。\n\n<indent=30><i>スピークイージーはサルーンに取って代わり、法を無視する巨大な軍団が現れた。多くの優れた市民が禁酒法を公然と無視している。</i></indent>\n <indent=40>—ジョン・D・ロックフェラー</indent>
info.player-piano.icon	<sprite name="skill expansions">
info.player-piano.name	プレーヤーピアノ
info.player-piano.desc	このスキルを習得すると、<link="backroom-bootlegger">密造酒場</link>や<link="corner-speakeasy">街角のスピークイージー</link>にビリヤード台を設置する拡張が可能になり、より多くの客を引き寄せ、日々の収益が増加します。\n\n<indent=30><i>スピークイージーはサルーンに取って代わり、法を無視する巨大な軍団が現れた。多くの優れた市民が禁酒法を公然と無視している。</i></indent> \n<indent=40>—ジョン・D・ロックフェラー</indent>
info.junkyard-booze.icon	<sprite name="skill expansions">
info.junkyard-booze.name	ジャンクヤード・ブーズ
info.junkyard-booze.desc	このスキルを習得することで、<link="homemade-booze">自家製酒</link>事業にジャンクヤードの改良設備を導入し、生産量を増加させることができます。\n\n<i><indent=30><i>深く根付いた好みは議論の余地がない――人を説得してビールを好きにさせることはできない。</i></indent> \n<indent=40>—オリバー・ウェンデル・ホームズ</indent>
info.bottle-return-racks.icon	<sprite name="skill old-knowledge">
info.bottle-return-racks.name	返却棚
info.bottle-return-racks.desc	\nこのスキルを習得すると、各拠点に瓶回収システムを設置することができ、定期的にリンクした<b><link="small-bottles">瓶</link></b>を集めて酒造事業の燃料として使用できるようになります。\n\n<i><indent=30>私は理想主義者です。どこに向かっているかはわかりませんが、進んでいます。</i></indent> \n<indent=40>—カール・サンドバーグ</indent>
info.ethnic-solidarity.icon	<sprite name="skill ethnic">
info.ethnic-solidarity.name	民族の連帯
info.ethnic-solidarity.desc	このスキルを習得すると、<link="homemade-booze">自家製酒</link>事業に「エスニック団結」拡張を設置でき、各生産サイクルで必要な材料の量を削減することができます。
info.ethnic-bump-cider.icon	<sprite name="skill ethnic">
info.ethnic-bump-cider.name	旧世界の知識：シードル
info.ethnic-bump-cider.desc	このスキルを習得すると、<link="cider">シードル</link>事業に「イングリッシュシードルプレス」拡張を設置でき、生産量を大幅に増加させることができます。\n\n<i><indent=30>「昨日のパン、今日の肉、そして昨年のシードルをくれ。」</i></indent>\n <indent=40>—ベンジャミン・フランクリン</indent>
info.ethnic-bump-wine.icon	<sprite name="skill ethnic">
info.ethnic-bump-wine.name	旧世界の知識：ワイン
info.ethnic-bump-wine.desc	このスキルを習得すると、<link="brick-wine">ワイン</link>事業に「イタリアンワインプレス」拡張を設置でき、生産量を大幅に増加させることができます。\n\n<i><indent=30>「ワインは最も健康的で、最も衛生的な飲み物である。」</i></indent> \n<indent=40>—ルイ・パスツール</indent>
info.ethnic-bump-beer.icon	<sprite name="skill ethnic">
info.ethnic-bump-beer.name	旧世界の知識：ビール
info.ethnic-bump-beer.desc	このスキルを習得すると、<link="home-brew">ビール</link>事業に「ドイツビールケトル」拡張を設置でき、生産量を大幅に増加させることができます。\n\n<i><indent=30>「ビールが醸造されるところでは、繁栄が訪れる。」</i></indent> \n<indent=40>—チェコのことわざ</indent>
info.ethnic-bump-liquor.icon	<sprite name="skill ethnic">
info.ethnic-bump-liquor.name	旧世界の知識：スピリッツ
info.ethnic-bump-liquor.desc	このスキルを習得すると、<link="moonshine">密造酒</link>事業に「ポーランド式蒸留器」拡張を設置でき、生産量を大幅に増加させることができます。\n\n<i><indent=30>「スコッチか何もないかの選択なら、スコッチを取るだろう。密造酒に最も近いものだからね。」</i></indent>\n <indent=40>—ウィリアム・フォークナー</indent>
info.ethnic-bump-fruit-brandy.icon	<sprite name="skill ethnic">
info.ethnic-bump-fruit-brandy.name	旧世界の知識：フルーツ蒸留
info.ethnic-bump-fruit-brandy.desc	このスキルを習得すると、<link="fruit-wine">果実酒を</link>事業に「南スラブ式蒸留器」拡張を設置でき、生産量を大幅に増加させることができます。\n\n<indent=30><i>「私はワインで料理をする、時々それを料理にも加えるんだ。」</i></indent> \n<indent=40>—W.C.フィールズ</indent>
info.better-bartending.icon	<sprite name="skill expansions">
info.better-bartending.name	より良いバーテンディング
info.better-bartending.desc	"このスキルを習得すると、<link="corner-speakeasy">街角潜り酒場</link>を<link="small-speakeasy">小型潜り酒場</link>にアップグレードすることができるようになる。\n\n<indent=30><i>潜り酒場がサルーンに取って代わり、法を犯す膨大な軍隊が出現し、優秀な市民の多くが公然と禁酒法を無視するようになった</i></indent>。\n<indent=40>-ジョン・D・ロックフェラー</indent>。"
info.label-counterfeiting.icon	<sprite name="skill labels">
info.label-counterfeiting.name	ラベルの偽造
info.label-counterfeiting.desc	このスキルを習得すると、管理する事業に <link="conversion-labels">偽造ラベル印刷機</link> を設置することができ、紙をラベルに変換し、さまざまなアルコール製品の生産に使用することができます。\n\n<indent=30><i>「ワインが入ると、奇妙なものが出てくる。」</i></indent>\n <indent=40>—ヨハン・シラー</indent>
info.ice-making.icon	<sprite name="skill ice making">
info.ice-making.name	製氷
info.ice-making.desc	このスキルを習得すると、あなたが支配するビジネスに<link="conversion-ice-house">製氷所</link>を建設することが可能になる。製氷所はガソリンを冷凍機の動力源として水を凍らすことで各種アルコール飲料の原料となる氷を製造する。\n\n<i><indent=30><i>文明は蒸留から始まる</i></indent>\n<indent=40>ーウィリアム・フォークナー</indent>
info.gambling-numbers.icon	<sprite name="skill gambling">
info.gambling-numbers.name	ナンバーズ・ゲーム
info.gambling-numbers.desc	この技術を習得すると、賭博場でさまざまな種類のナンバーズ・ゲームを利用可能になる。\n\n<i><indent=30><i>勝ち札を持っているときは、常にフェアなプレーを心がけなければならない。</i></indent>\n<indent=40>ーオスカー・ワイルド</indent>
info.gambling-cards.icon	<sprite name="skill gambling">
info.gambling-cards.name	カードゲーム
info.gambling-cards.desc	この技術を習得すると、賭博場でさまざまな種類のカードゲームを利用可能になる。\n\n<i><indent=30><i>勝ち札を持っているときは、常にフェアなプレーを心がけなければならない。</i></indent>\n<indent=40>ーオスカー・ワイルド</indent>
info.gambling-tables.icon	<sprite name="skill gambling">
info.gambling-tables.name	テーブルゲーム
info.gambling-tables.desc	この技術を習得すると、賭博場でさまざまな種類のテーブルゲームを利用可能になる。\n\n<i><indent=30><i>勝ち札を持っているときは、常にフェアなプレーを心がけなければならない。</i></indent>\n<indent=40>オスカー・ワイルド</indent>
info.gambling-clean-money.icon	<sprite name="skill gambling">
info.gambling-clean-money.name	資金洗浄
info.gambling-clean-money.desc	この技術を習得することで<link="gambling-den">小さな賭博場</link>を拡張して、より収益力が高い様々な出し物を設置できる様になる。\n\n<i><indent=30><i>勝ち札を持っているときは、常にフェアなプレーを心がけなければならない。</i></indent>\n<indent=40>ーオスカー・ワイルド</indent>
info.gambling-secret-books.icon	<sprite name="skill gambling">
info.gambling-secret-books.name	不正会計
info.gambling-secret-books.desc	この技術を習得すると<link="gambling-den">中規模な賭博場</link>や<link="casino">小規模なカジノ</link>を拡張してより収益力が高い様々な出し物を設置できる様になる。\n\n<i><indent=30><i>勝ち札を持っているときは、常にフェアなプレーを心がけなければならない。</i></indent>\n<indent=40>ーオスカー・ワイルド</indent>
info.gambling-high-rollers.icon	<sprite name="skill gambling">
info.gambling-high-rollers.name	ハイローラー・ジャンケット
info.gambling-high-rollers.desc	この技術を習得するとあなたの賭博事業は各地のハイローラーたちの憧れの的となり、賭博事業を最高レベルにアップグレードできるほか、ハイローラーたちをターゲットにしたいくつかの出し物を利用することが可能になる。\n\n<i><indent=30><i>勝ち札を持っているときは、常にフェアなプレーを心がけなければならない。</i></indent>\n<indent=40>ーオスカー・ワイルド</indent>
info.gambling-furnishing.icon	<sprite name="skill gambling">
info.gambling-furnishing.name	輸入家具
info.gambling-furnishing.desc	この技術を習得すると海外から家具を輸入することで、あなたの賭場を改善するいくつかの出し物が利用可能になる。\n\n<i><indent=30><i>勝ち札を持っているときは、常にフェアなプレーを心がけなければならない。</i></indent>\n<indent=40>ーオスカー・ワイルド</indent>
info.gambling-service.icon	<sprite name="skill gambling">
info.gambling-service.name	心地よいサービス
info.gambling-service.desc	<indent=10>専門的で威圧感のないスタッフは、あなたが犯罪組織を運営していることを客に忘れさせる。そういう安心感は、債務整理をするときに役立つ。\n\n<b>必要なもの：</b>\n<sprite name="skill gambling"><link="gambling-cards">カードゲーム</link>、<sprite name="skill gambling"><link="gambling-numbers">ナンバーズ・ゲーム</link>、<sprite name="skill gambling"><link="gambling-tables">テーブルゲーム</link>、<sprite name="skill gambling"><link="gambling-service">心地よいサービス</link><sprite name="res cash">2500</indent>\n\n制服を着た係員がいると、常連客の債権額を大きくし、より早く返済してもらうことが可能となる。\n\n<i><indent=30><i>勝ち札を持っているときは、常にフェアなプレーを心がけなければならない。</i></indent>\n<indent=40>ーオスカー・ワイルド</indent>
info.gambling-staff.icon	<sprite name="skill gambling">
info.gambling-staff.name	気の利くスタッフ
info.gambling-staff.desc	この技術を習得すると、あなたの賭博事業において優秀で親切なスタッフを雇えるようになり、賭博場を改善するいくつかの出し物が利用可能となる。\n\n<i><indent=30><i>勝ち札を持っているときは、常にフェアなプレーを心がけなければならない。</i></indent>\n<indent=40>ーオスカー・ワイルド</indent>
info.starter-buildings.icon	<sprite name="skill ethnic">
info.starter-buildings.name	素敵な建物
info.starter-buildings.desc	このスキルによって、あなたはビル管理のエキスパートとなり、新規ビルのコストを削減し、運用担当者の経験値を上げ、運用で発生する熱量を削減することができます。
info.starter-crew.icon	<sprite name="skill ethnic">
info.starter-crew.name	組織犯罪
info.starter-crew.desc	このスキルを使用すると、口が達者で有能なリーダーになり、民族を共有することで人間関係が円滑になり、違法な物品を売買したり、ミッションの上限が増加したりします。
info.starter-cops.icon	<sprite name="skill ethnic">
info.starter-cops.name	法の尊重
info.starter-cops.desc	賄賂のコストを下げ、賄賂の期間を長くし、警察が襲撃しにくくなるなど、より効果的に法律を扱うことができるようになるスキルです。
info.starter-vehicles.icon	<sprite name="skill ethnic">
info.starter-vehicles.name	天性のメカニック
info.starter-vehicles.desc	トラックスロットが1つ増え、車両の修理代が安くなり、車両のダメージが軽減されるなど、車両の運用がよりスムーズになるスキルです。
info.starter-combat.icon	<sprite name="skill ethnic">
info.starter-combat.name	街の喧嘩屋
info.starter-combat.desc	火器以外の武器のダメージと命中率が上昇し、強力なファイターとなる。
info.starter-goons.icon	<sprite name="skill ethnic">
info.starter-goons.name	ごろつきからの尊敬
info.starter-goons.desc	このスキルを使用すると、街で出会う低レベルのチンピラたちの間で愛されやすくなり、彼らを買収するために必要な現金の量や、彼らが機会を求めてくること、そして彼らがあなたの要求に逆らう可能性を減らすことができます。
info.starter-territory.icon	<sprite name="skill ethnic">
info.starter-territory.name	テリトリーの獲得
info.starter-territory.desc	このスキルにより、より効果的にテリトリーを管理できるようになり、新しいフロントを創設するコストを削減し、新しいコーナーが領地に加わる速度を向上させることができる。
info.businesses.name	合法的なビジネス
info.businesses.desc	"各店舗のショーウィンドウの奥、荷積みドックの先、棚や保管スペースの中に、ビジネスが街の経済の心臓部として存在しています。\n\nその一部の企業は表面上合法的な業務を行っているように見えますが、その裏には密造や地下室で行われる違法な活動が隠されています。ビジネスは、原材料の購入、違法な事業の成果を売却する場所であり、<link="vehicles">車両</link>の取引やその他あらゆる活動の拠点です。\n\n一度あなたが建物を<sprite name="ui pip social expansion"> <link="controlled-buildings">支配</link>すれば、表向きは通常の業務が続き、あなたの組織は裏の部屋や地下室を自由に使って新たな事業を展開できるようになります。"
info.controlled-buildings.icon	<sprite name="ui pip social expansion">
info.controlled-buildings.name	支配されている建物
info.controlled-buildings.desc	"組織が支配するビジネスは、さまざまな事業を展開できる拠点です。\n\nあなたの組織、または<Link="rivals">ライバル組織</Link>が、過去の取引で得た<Link="favors">恩義</Link>を使って、近隣のビジネスに拡大することができます。ただし、ビジネスが狙うのは、すでにあなたの<Link="territory">勢力圏</Link>にある建物のみなので、より広い勢力圏を持っているほど、ターゲットにできる建物が増えます。組織はビジネス拡大のための資金を提供し、その後、協力的なビジネスの一員が<sprite name="ui pip social expansion">正当なビジネス</sprite>を運営しつつ、裏で組織の事業が進行します。恩義を持つオーナーや、潜在的な<sprite name="ui pip social expansion">乗っ取りの機会</sprite>に注意しておくと良いでしょう。"
info.favors.icon	<sprite name="ui tickets">
info.favors.name	恩義
info.favors.desc	"物事を進めるには誰かとの繋がりが重要です。\n\n関係を広げて信頼を築けば、相手は様々な方法であなたを助けてくれるようになります。<sprite name="ui tickets"> 恩義</sprite>は、彼らの<sprite name="ui pip social"> <link="relationships">信頼</link>を活かして、組織の利益を推し進めるための重要な手段です。恩義を利用して以下のことが可能です：\n<indent=20><sprite name="ui social biz intro"> <link="introductions">他のビジネスオーナーの紹介</link>\n<sprite name="ui pip social"> <link="boost">既知のビジネスオーナーとの信頼度の向上</link> \n<sprite name="ui pip social expansion"> <link="controlled-buildings">建物の支配権の取得</link> \n<sprite name="ui social goon intro"> <link="goons">地元のチンピラの紹介</link> \n<sprite name="police station"> <link="police">地元の警察官の紹介</link> \n<sprite name="ui pip territory expand"> <link="fronts">新たなフロントの設立による勢力拡大</link> \n<sprite name="ui skills"> <link="skills">新しいスキルの習得</link> \n<sprite name="ui crew list"> <link="crew">新しいクルーメンバーの発見</link></indent>"
info.introductions.icon	<sprite name="ui social biz intro">
info.introductions.name	紹介
info.introductions.desc	友人に有益な人物を紹介してもらいましょう。\n\nビジネスの取引先との関係で得た<sprite name="ui tickets"><link="favors">恩恵</link>を利用し、あなたが販売するものを購入してくれる、または生産に使える何かを売ってくれる可能性がある人物について紹介を受けましょう。
info.boost.icon	<sprite name="ui pip social">
info.boost.name	関係強化
info.boost.desc	"友人に紹介してもらい、関係を改善する\n\nフレンドリーなビジネスパートナーから得た <sprite name="ui tickets"> <link="favors">好意</link> を利用して、共通の知人との <sprite name="ui pip social"> <link="relationships">関係</link> を改善しましょう。彼らと関係を深めることで、違法な商品を販売したり、 <sprite name="ui pip front ready again"> <link="fronts">フロント</link> を新たに設立して <sprite name="ui pip territory expand"> <link="territory">テリトリー</link> を拡大する機会を得られるかもしれません。また、その人物があなたが「繋がり」を得たいと思っている誰かを知っている場合や、単に友好的な関係を築きたいだけの場合にも役立ちます。どんな理由であれ、友人の友人との良好な関係を築く方法はこれです。"
info.police.icon	<sprite name="police station">
info.police.name	警察
info.police.desc	"法律を執行する青い制服の人たち\n\n警官たちは、違法行為を見つけるために街を巡回します。もし特定の <sprite name="ui heat"> <link="heat">ヒート</link> が高い <sprite name="ui corner"> <link="corners">街角</link> があれば、数ターンにわたってそこに留まります。警官が見張っている街角で誰かが怪しいことをすると、その人物は逮捕されます。まあ、実際にはその人物の所持金をすべて取り上げ、<link="vehicles">車両</link>にあるものを没収するでしょう。警官が街角にいる間は、地元の <link="businesses">ビジネス</link> も違法なことをすることを嫌がります。事実、警官がいなくなるまで、ビジネス全般に消極的になります。\n\nもし警官と繋がりができれば、彼らの「お気に入りの慈善団体」に少しの現金を提供することができます。そうすれば、あなたの組織が活動しているときには目をつむってくれるでしょう。さらに、<sprite name="ui pip territory expand"> <link="territory">テリトリー</link> からも手を引き、どれだけ熱が高くなろうとも関与しなくなります。"
info.goons.icon	<sprite name="ui goon defiant">
info.goons.name	コーナーフーリーガン
info.goons.desc	"地元の怠け者、役立たず、その他の厄介者たち\n\n街の一角を占拠しているのは、ただの <sprite name="ui corner"> <link="corners">街角</link> だけを支配しているゴロツキたちです。彼らは時々、他の <link="rivals">組織</link> や他のゴロツキに対して攻撃的になることもありますが、ただ場所を占拠しているだけの者もいます。もし彼らと繋がりを持つことができれば、<sprite name="ui tickets"> <link="favors">恩義</link> を利用して、彼らが持っている機会を考慮することも可能です。\n\n彼らが時折、<link="businesses">ビジネスの所有者</link>、つまりあなたに <sprite name="ui tribute"> <link="protection">保護料</link> を支払っている、または重要な取引をしているビジネスに迷惑をかけることがあります。その場合、あなた自身が対処しなければならないかもしれません。脅してやめさせるか、もし彼らと繋がりがあれば、彼らに金を払って別の場所で他のことをやるように依頼することもできます。それでも解決しない場合は、古典的な喧嘩に持ち込むしかないでしょう。\n\n<indent=30><i>追跡が最も難しい犯罪は、目的のない犯罪である。</i></indent> \n<indent=40>—アーサー・コナン・ドイル</indent>"
info.fronts.icon	<sprite name="ui pip front ready again">
info.fronts.name	フロント
info.fronts.desc	"あなたの組織の利益を代表し、勢力拡大と維持を行うビジネスパートナー\n\n地域で組織の <sprite name="ui respect"> <link="respect">尊敬</link> を拡大し、維持するためには、街の動向に敏感な人物が必要です。<sprite name="ui tickets"> <link="favors">恩義</link> を利用して <link="businesses">ビジネス</link> を前線として機能させることができます。彼らは、周辺の角にいる人々がどう反応するかを教えてくれるので、尊敬レベルを上げることが可能です。尊敬レベルが十分に高まると、その <sprite name="ui corner"> <link="corners">角</link> があなたの <sprite name="ui pip territory expand"> <link="territory">領地</link> の一部となります。\n\n保護料を支払っているビジネスは、毎月の貢献金をあなたの前線に届けます。前線が必要とする額を上回る保護料を手配すれば、余剰分を回収できます。一方で、保護料が不足している場合は、前線を維持するために不足分を補わなければなりません。"
info.skills.icon	<sprite name="ui skills">
info.skills.name	技術
info.skills.desc	"スキルによって、新しい作戦の種類、作戦のアップグレードや拡張、新しい<link="resource">材料</link>の種類、その他あなたの組織に役立つ知識の断片が解除されます。\n\n時には、新しいことを教えてくれるような、とても役に立つ友人を作ることもできます。<sprite name="ui tickets"> <link="favors">恩義</link>といくつかのリソースや現金と引き換えに、あなたに自分の知っていることを教えてくれるでしょう。既存のオペレーションを改善する、新しいものを作ることについて学ぶ、禁酒法がもたらす需要に対応するために、あなたの組織の能力を拡張してくれる有用な友人を探してください。\n\n<indent=30><i>この問題やあの問題は科学では決して解決されないと断言するのは、ほとんど知らない人であり、多くを知らない人ではないのです</i></indent>\n<indent=40>-チャールズ・ダーウィン</indent>。"
info.crew.icon	<sprite name="ui crew list">
info.crew.name	構成員
info.crew.desc	あなたがこの街でやろうとする全てにおいて頼りになる人々だ。\n\n<link="vehicles">車両</link>の運用や事業運営はあなたの組織の構成員によって行われる。彼らには街中での荷物の移動を助ける配達を担当させることができる。\n彼らは武器で武装して、反抗的な<sprite name="ui goon defiant"> <link="goons">ごろつき</link>に対処したり、<link="rivals">ライバル組織</link>にメッセージを送ることができる。\n\n<sprite name="ui pip territory expand"><link="territory">テリトリー</link>を拡張<sprite name="ui pip social expansion">し、 <link="controlled-buildings">建物</link> を追加支配すると、構成員の最大数を増やすことができる。\n\nあなたに対して<sprite name="ui tickets"><link="favors">恩義</link>を感じていて、良い<sprite name="ui pip social crew">構成員候補を知っているオーナーが所有する<link="businesses">ビジネス</link>を探そう。構成員候補にさせたいと考えている仕事とその特徴が合っているかどうか、必ず確認しよう。
info.territory.icon	<sprite name="ui pip territory expand">
info.territory.name	テリトリー
info.territory.desc	"領地とは、組織がフロントから得た尊敬によって支配している街角のことです。\n\n領地は、組織が支配している街の地理的範囲を指します。あなたの組織の <sprite name="ui respect"> 尊敬が特定の <sprite name="ui corner"> <link="corners">街角</link> で十分に高まると、その角を支配下に置けます。領地に新たな角を追加する主なメリットは以下の通りです：\n\n<indent=20><sprite name="ui pip social expansion"> <link="controlled-buildings">新たな建物を支配下に置く能力を獲得</link>\n <sprite name="ui tribute"> <link="protection">地元ビジネスへの保護料の強要</link> \n<sprite name="ui heat"> <link="police">警察への賄賂を払い、どんなに熱が高まっても見逃してもらう</link>\n <sprite name="ui quests"> <link="missions">一部のミッションは、領地内のビジネスからしか利用できない</link>\n <sprite name="ui crew list"> <link="crew">領地を拡大することで、クルーの人数を増やせる</link> \n<sprite name="ui skills"> <link="skills">一部のスキルは、領地に含まれる街角の数が一定以上必要</link> \n<sprite name="ui biz closed"> <link="rivals">ライバル組織は、あなたの領地内で営業しているビジネスと取引できなくなる</link>\n <sprite name="civic building"> 領地内にある鉄道駅や郵便局などの公共施設からの利益を得る</indent>"
info.protection.icon	<sprite name="ui tribute">
info.protection.name	保護ビジネス
info.protection.desc	"いい場所だね。 何かあったら残念だ。\n\n街角 <sprite name="ui corner"> <link="corners">corner</link> が組織の <sprite name="ui pip territory expand"> <link="territory">領地</link> に含まれると、保護料を要求することが可能になります。ビジネスオーナーとの <sprite name="ui pip social"> <link="relationships">関係</link> が良好であれば、ライバル組織 <link="rivals">rival outfits</link>、地元のごろつき <sprite name="ui goon defiant"> <link="goons">hooligans</link>、そして監視をする警察 <sprite name="police station"> <link="police">police</link> からエリアを守ってもらえることに満足するかもしれません。毎月の現金封筒に若干の抵抗感を抱くかもしれませんが、通常のビジネスは問題なく進行します。\n\nただし、オーナーとの関係が薄いか、彼らがあなたに敵対している場合、保護料の要求は関係に深刻なダメージを与え、月々の支払い以外での協力を拒否される可能性があります。\n\n場合によっては、ビジネスオーナーが保護料を断固として拒否することもあります。その際は、彼らの勇気を尊重するか、窓を壊すか、あなたの判断にかかっています。\n\nいずれにしても、保護が受け入れられれば、彼らは最寄りの <sprite name="ui pip front extortion"> <link="fronts">フロント</link> に献金を届け、また他の組織や地元の不良からそのエリアを守るように期待されます。"
info.heat.icon	<sprite name="ui heat">
info.heat.name	ヒート
info.heat.desc	都市全体の熱のレベルは、<sprite name="ui map heat">ヒートマップオーバーレイで確認するか、任意の <sprite name="ui corner"> <link="corners">街角</link> をクリックして確認できます。\n\n熱は違法行為によって発生します。これには、違法な商品を売買したり、違法な事業を設立したり、新しい <sprite name="ui pip front extortion"> <link="fronts">フロント</link> を設置したり、地元商人から <sprite name="ui tribute"> <link="protection">保護料</link> を要求したり、<sprite name="ui goon defiant"> <link="goons">地元のごろつき</link> やライバル組織と喧嘩やストリートファイトをしたりする行為が含まれます。\n\n熱が高まりすぎると、<sprite name="police station"> <link="police">警察</link> はその地域の <sprite name="ui map police"> <link="precincts">管轄区域</link> から取り締まりを行い、その街角や周辺での犯罪行為を阻止し、地元の住民があなたの組織と取引するのをためらわせ、怪しい行動をしているとみなされた人物を逮捕します。\n\nさらに、熱は発生源の街角から隣接する街角へと広がっていきます。
info.corners.icon	<sprite name="ui corner">
info.corners.name	コーナー
info.corners.desc	コーナーは、あなたの <sprite name="ui pip territory expand"> <link="territory">縄張り</link> の基本単位です。<sprite name="ui crew list"> <link="ui crew">クルーメンバー</link> は、自分が現在いる街角にある <link="businesses">ビジネス</link> に対して操作を行うことができます。あなたの <sprite name="ui pip front extortion"> <link="fronts">フロント</link> は、通りで繋がっている隣接する街角へと拡大します。<sprite name="ui heat"> <link="heat">ヒート</link> は、違法行為が行われた街角に蓄積されますが、隣接する街角にも広がっていきます。
info.precincts.icon	<sprite name="ui map police">
info.precincts.name	警察管区
info.precincts.desc	"<sprite name="ui map police">警察管区マップオーバーレイで、市全体の警察組織の分担を見ることができます。また、特定の <sprite name="ui corner"> <link="corners">コーナー</link> をクリックすると、その情報が表示され、どの管区に属するかを確認できます。\n\n<sprite name="police station"> <link="police">警察官</link> にはそれぞれ所属する警察署があり、管区を構成しています。また警察官を買収することができれば、<sprite name="ui pip territory expand"> <link="territory">テリトリー</link> と管轄区域が重なる場所では、<sprite name="ui heat"> <link="heat">ヒート値</link> を無視するようになります。"
info.respect.icon	<sprite name="ui respect">
info.respect.name	リスペクト
info.respect.desc	市内のリスペクトを確認するには、<sprite name="ui map respect"> リスペクトマップのオーバーレイを表示するか、任意のコーナーをクリックします。リスペクトは、地域の人々があなたの組織にどれだけ親しみを持っているかを測る指標です。あなたの<sprite name="ui pip territory expand"> <link="fronts">フロント</link>は、地域のリスペクトを増やす主要な手段です。それを運営しているビジネスオーナーたちは、近隣の<link="corners">コーナー</link>ごとに、住民が何に感銘を受けるかを理解しています。コーナーは、最初に占領した組織や、最も高いリスペクトを持つ組織によって支配されます。\n\nリスペクトはまた、地域の商人と取引をしたり、<link="backroom-bootlegger">密造酒の販売業者</link>や<link="corner-speakeasy">街角のスピークイージー</link>など、違法な酒類を直接販売する事業を運営することで得られます。リスペクトは<sprite name="ui heat"> <link="heat">ヒート</link>と同様に、隣接する通りに接続されたコーナーにも広がります。
info.ethnicity.icon	<sprite name="ui ethnicity general">
info.ethnicity.name	民族
info.ethnicity.desc	"<sprite name="ui map ethnic"> 人口マップオーバーレイで、都市の民族的内訳と近隣の配置を見ることができます。\n\n禁酒法時代の都市は、米国史上最大規模の移民の波が押し寄せ、移民で溢れていた。これらのグループは、社会的にも地理的にも、一緒に行動しています。 自分や<sprite name="ui crew list"><link="crew">構成員</link>と同じ民族の他人と接すると、<sprite name="ui pip social"><link="relationships">人間関係</link>が少し良くなる。<sprite name="ui quests"> <link="mission">ミッション</link>， <sprite name="ui skills"> <link="skills">スキル</link> などの特別な効果も、同じ民族の人と接していれば得られる場合がある。"
info.arrests.name	逮捕
info.arrests.desc	犯罪を犯すと、逮捕される可能性があります。\n\nもし、<sprite name="ui heat"> <link="heat">ヒート</link>が高く、その結果として<sprite name="police station"> <link="police">警察</link>が特定のコーナーに出動した場合、そのコーナーでターンを終了したあなたの<link="crew">クルーメンバー</link>が逮捕されるかもしれません。その場合、警官はそのクルーメンバーが所持している現金や<link="vehicles">車両</link>内の貨物を全て没収します。\n\nしかし、あなたの組織が賄賂を支払った<sprite name="ui map police"> <link="precincts">管轄区域</link>内にいる場合、警察は見て見ぬふりをし、ヒートの値に関わらず逮捕は行われません。しかし、<sprite name="ui pip territory expand"> <link="territory">自分の領土</link>外では、警察が移動するまで近くの<link="businesses">ビジネス</link>での取引を阻止されることがあります。
info.rivals.name	ライバル組織
info.rivals.desc	この街は全員が住むには狭すぎるかもしれない。\n\n禁酒法時代、闇市場で商売を始めることはそれほど珍しいアイデアではなかったようです。街での犯罪活動の多くは、一部の<sprite name="ui goon defiant"> <link="goons">小物の街角のチンピラ</link>に限られているものの、あなたの組織と張り合うことができる他の組織もいくつか存在します。彼らに出会うと、無視されることもあれば、脅威と見なされることもあります。あるいは、あなた自身が脅威と見なすことを決めるかもしれません。\n\n公然とした<sprite name="ui ai aggro"> <link="hostility">対立</link>はビジネスに悪影響を与えますが、時には避けられない場合もあります。ライバルに対して何を避け、何に立ち向かうべきかを決めるのは、組織のボスであるあなた次第です。
info.hostility.icon	<sprite name="ui ai aggro">
info.hostility.name	敵意と対立
info.hostility.desc	他の組織があなたの組織を嫌い、行動に移すと決めたとき。\n\n地元のチンピラや<sprite name="ui goon defiant"> <link="rivals">ライバル組織</link>が、相互不信から公然とした対立へとエスカレートさせる理由は多岐にわたります。\n\n地元のチンピラにとって、これは彼らが支配する<sprite name="ui corner"> <link="corners">街角</link>に近づきすぎた場合、あなたのクルーメンバーを攻撃することを意味し、数ブロック先まで追いかけることもあります。以前、彼らと街角で商取引を行うための合意があった場合、その取り決めは終わりを迎え、地元の商人に嫌がらせをしないという合意も解除されます。\n\n地元のチンピラとの対立の引き金となるのは、彼らの街角で長時間過ごすこと、彼らの家族に敵対的な行動を取ること、または彼らを直接攻撃することです。また、地元のチンピラは新参者に対して敏感で、最初から敵対的な態度を取ることもありますが、それは時間が経つにつれて慣れてくるでしょう。\n\nライバル組織があなたに敵対する場合、彼らにはさまざまな選択肢があります。彼らは時々クルーを集めて、あなたのクルーメンバーを<sprite name="ui combat">攻撃することがあります。武装が整っていれば、そのクルーメンバーにとって不幸な結果になる可能性があり、最悪の場合、<sprite name="ui dead crew">死亡に至ることもあります。\n\n彼らはあなたの<sprite name="ui pip territory expand"> <link="fronts">フロント</link>を狙い、ビジネスオーナーに<sprite name="ui player lost front">閉鎖を促すかもしれません。\n\nあなたの<sprite name="ui pip social expansion"> <link="controlled-buildings">管理している建物</link>も攻撃され、損傷を受け、修理が完了するまで機能しなくなるでしょう。\n\n彼らはあなたの組織の近隣の<sprite name="ui corner raided">街角を襲撃し、そこのビジネスがしばらくの間取引を停止し、あなたの組織との関係が悪化する原因を作るかもしれません。\n\nいずれの場合も、<sprite name="ui heat"> <link="heat">ヒート</link>が急上昇し、<sprite name="police station"> <link="police">地元の警察</link>からの注意が増加する結果を招くことを覚悟する必要があります。\n\nこれらすべては非常に費用がかさみ、あなたの組織の存続をさらに不安定にします。地元のチンピラに対しては、単純に彼らに停止を要求できます。もしあなたの組織が彼らよりも多くの人員と武器を持っているなら、彼らは自分の街角に引きこもり、あなたに干渉しないでしょう。\n\nライバル組織に対しては、<sprite name="ui truce started"> <link="truce">休戦</link>を求める必要があり、これによって一時的に敵対行為を停止させることができます
info.truce.icon	<sprite name="ui truce started">
info.truce.name	停戦
info.truce.desc	時には対立が必要なこともありますが、時にはビジネスにとって悪影響を及ぼします。\n\nもしあなたが<sprite name="ui ai aggro"> <link="hostility">敵対行為</link>に参加している場合、<link="rivals">ライバル組織</link>と戦っている最中であれば、相手に休戦を求めるか、相手から休戦の申し出があるかもしれません。あなたが休戦を求める場合、相手の組織はその代償として一定の金額を要求してくる可能性が高く、その金額を支払うことで敵対行為を終わらせることができます。\n\nしかし、ライバル組織の方から中立地帯であなたのクルーメンバーとの会合を求めてきた場合、これは現在の対立が彼らにとって不利な方向に進んでいることを意味します。この場合、あなたの組織が現金を受け取って争いを終わらせることができるでしょう。\n\n一度休戦が開始されると、ライバル組織は休戦期間中、すべての挑発的な行動を停止します。しかし、もし休戦中のライバルに対して敵対的な行動を取ることを決断した場合、敵対行為は即座に全面的に再開されることを覚悟しなければなりません。
info.relationships.icon	<sprite name="ui pip social">
info.relationships.name	関係と信頼
info.relationships.desc	都市の裏社会では、誰を知っているか、誰を信用できるかが、あなたのアウトフィットの成功にとって極めて重要です。\n\nあなたの関係スコアは、他者との歴史を要約したもので、好意的な直接的なやり取りやミッションの完了などで向上します。逆に、<sprite name="ui tribute"> <link="protection">保護料</link>を強要したり、<sprite name="ui goon defiant"> <link="goons">敵対的な地元のならず者</link>から彼らのビジネスを守れなかったりすることで、ネガティブに影響します。\n\n関係は性格にも影響されます。例えば、同じ<sprite name="ui ethnicity general"> <link="ethnicity">民族</link>であれば、信頼関係は高まりやすくなります。一方で、相手が慎重な性格の場合は、初めから信頼が低くなることもあります。\n\nまた、結果は社会的に広がります。誰かを助けてミッションを完了すれば、その人の家族全体との関係が良くなります。同様に、誰かの窓を割れば、その人は知り合い全員にあなたが信用できない人物だと伝えるので、関係に悪影響を及ぼします。\n\n相手が十分にあなたを信用すると、違法な活動について相談してくるようになります。さらに信頼を得れば、<sprite name="ui tickets"> <link="favors">恩恵</link>として、紹介やスキル、その他多くの有益なものを提供してくれるでしょう。\n\nそのため、自分の行動が社会的にどのように響くか、常に念頭に置いておきましょう。
info.missions.icon	<sprite name="ui quests">
info.missions.name	ミッション
info.missions.desc	ビジネスオーナーは、時折あなたを助けるためのアイデアを持っていたり、自分自身が助けを必要としていたり、何らかのリクエストを持っていることがあります。\n\n街中を走っていると、<sprite name="ui pip quest available">の表示が見えることがあり、これはある<link="businesses">ビジネスオーナー</link>があなたと話をしたがっているサインです。あなたの組織が成長し、さまざまな方向に拡大していくと、取引している人々は、あなたのアウトフィットの活動に注目し続けます。その結果、彼らは時折、あなたに有益な機会を提示してくることがあります。これには、生産性の向上、新たな<sprite name="ui skills"><link="skills">スキル</link>の習得、未知の<link="resources">リソース</link>の発見、武器や<link="vehicles">車両</link>の入手、<sprite name="ui tickets"> <link="favors">恩恵</link>の追加、または都市の犯罪界を支配するための重要な機会の提供などが含まれます。\n\nこれらのミッションの中には、特定の期限内に完了しなければならないものもありますが、より柔軟で、あなたのアウトフィットが準備できたときに完了できるものもあります。\n\nあなたの<sprite name="ui pip territory expand"> <link="territory">テリトリー</link>や<sprite name="ui crew list"> <link="crew">クルー</link>が成長するにつれて、同時に受けられるミッションの数も増加します。市民はあなたが新たなミッションを受け入れられる状態にあるときにしか新しいミッションを提供しないため、1つのミッションを完了したら、街中を探索して新しいミッションが発生しているか確認しましょう。\n\nクルーには常に新しいミッションがないか注意を払わせておきましょう。これらは有益な機会となることがあり、誰かを助ければ、あなたの信頼性が広まり、さらに多くの機会がもたらされるかもしれません。逆に、助けると約束して反故にすると、一部のコミュニティでは不信感を持たれる可能性もあります。
info.vehicles.name	車両
info.vehicles.desc	1920年代の活気に満ちた都市のジャングルで、クルーや商品をA地点からB地点、そしてC地点やD地点へと移動するためには、車両が欠かせません。\n\n車両は大きく分けて2つのカテゴリに分類されます。<sprite name="ui car">乗用車と<sprite name="ui truck">配送車です。乗用車は手に入りやすく、メンテナンスも簡単です。ディーラー、ジャンクヤード、街中のガレージで安価で手に入れることができます。一方、配送車両は、<sprite name="ui skills"> <link="skills">スキル</link>が必要で、専用のインフラが必要です。\n\n車両の数を増やすには、<sprite name="ui pip social expansion"> <link="buildings">新しい建物</link>を支配するか、支配下の建物の裏にガレージを建設する、あるいは、<link="businesses">ビジネスオーナー</link>からの<sprite name="ui quests"><link="missions">依頼</link>を完了して報酬としてガレージを獲得するなどの方法があります。\n\n街中を走り回ると、車両は徐々に摩耗していきます。そのため、修理できるガレージやその他のビジネスを見つけたり、自分で車両インフラを整えることが重要です。
info.slot-machines.name	スロットマシン
info.slot-machines.desc	<indent=10>小銭を賭けてドラムを回転させ、それが止まったときにシンボルが揃えば大きなリターンが得られる、少ない賭け金で楽しめるロウ・ステークス・ゲーム。\n\n<b>必要なもの：</b>\n<sprite name="res cash">1000</indent>\n\nこの出し物は賭博場に<sprite name="res cash">500以上の資金がある限り、遊ぶ客から平均<sprite name="res cash">1の賭け金を受け取る<link="low-stakes">ロウ・ステークス・ゲーム</link>として稼働する。一度に最大50人のプレイヤーが参加でき、2％の確率で賭け金の25倍の賞金を獲得することができる。\n\n<i><indent=30><i>勝ち札を持っているときは、常にフェアなプレーを心がけなければならない。</i></indent>\n<indent=40>ーオスカー・ワイルド</indent>
info.blackboards.name	賭けスポーツ
info.blackboards.desc	<indent=10>ローカルスポーツの結果やスタッツに大金を賭ける、カジュアルなプレーヤーが集まるロウ・ステークスのゲーム。確率は高くはないが、少なくとも家が建つだけの金にはならない。\n\n<b>必要なもの：</b>\n<sprite name="res cash">2500</indent>\n\nこの出し物は<link="low-stakes">ロウ・ステークス・ゲーム</link>として稼働し、賭博場に<sprite name="res cash">1500の資金がある限りは遊ぶ客から平均<sprite name="res cash">5の賭け金を受け取る。一度に最大25人のプレイヤーが参加でき、2％の確率で賭け金の30倍の賞金を獲得することができる。\n\n<i><indent=30><i>勝ち札を持っているときは、常にフェアなプレーを心がけなければならない。</i></indent>\n<indent=40>ーオスカー・ワイルド</indent>
info.faro.name	ファロ
info.faro.desc	<indent=10>簡単なカードゲームで少額の金を賭ける気軽に楽しめるロウ・ステークス・ゲーム。\n\n<b>必要なもの：</b>\n<sprite name="skill gambling"><link="gambling-cards">カードゲーム</link>、<sprite name="res cash">2000</indent>\n\nこの出し物は賭博場に<sprite name="res cash">750以上の資金がある限り、遊ぶ客から平均<sprite name="res cash">2の賭け金を受け取る<link="low-stakes">ロウ・ステークス・ゲーム</link>として稼働する。一度に最大100人のプレイヤーが参加でき、2％の確率で賭け金の30倍の賞金を獲得することができる。\n\n<i><indent=30><i>勝ち札を持っているときは、常にフェアなプレーを心がけなければならない。</i></indent>\n<indent=40>ーオスカー・ワイルド</indent>
info.high-stakes-slots.name	高配当のスロット
info.high-stakes-slots.desc	<b>一部の都市での利用可能な賭博の出し物</b>\n\n<indent=10>悪いオッズに対してペニースロットより少し大きな金を賭けるカジュアルな客に人気があるロウ・ステークス・ゲーム。なぜそんなことをするかって？より大きな配当が約束されているからである。\n\n<b>必要なもの：</b>\n<sprite name="skill gambling"><link="gambling-high-rollers">ハイローラーズ・ジャンケット</link>、<sprite name="res cash">7500</indent>\n\nこの出し物は賭博場に<sprite name="res cash">3500以上の資金がある限り、プレイヤーから平均<sprite name="res cash">4の賭け金を受け取る<link="low-stakes">ロウ・ステークス・ゲーム</link>として稼働する。一度に最大100人のプレイヤーが参加でき、1％の確率で賭け金の50倍の賞金を獲得することができる。\n\n<i><indent=30><i>勝ち札を持っているときは、常にフェアなプレーを心がけなければならない。</i></indent>\n<indent=40>ーオスカー・ワイルド</indent>
info.policy-game.name	ポリシーゲーム
info.policy-game.desc	<indent=10>ホイールから落ちてくる数字を当てる限定版の宝くじに少額の金を賭ける、気軽に遊べるロウ・ステークス・ゲーム。\n\n<b>必要なもの：</b>\n<sprite name="res cash">500</indent>\n\nこの出し物は賭博場に<sprite name="res cash">500以上の資金がある限り、プレイヤーから平均<sprite name="res cash">1.50の賭け金を受け取る<link="low-stakes">ロウ・ステークス・ゲーム</link>として稼働する。一度に最大75人のプレイヤーが参加でき、5％の確率で賭け金の10倍の賞金を獲得することができる。\n\n<i><indent=30><i>勝ち札を持っているときは、常にフェアなプレーを心がけなければならない。</i></indent>\n<indent=40>ー—Oscar Wilde</indent>
info.numbers-game.name	ブックメーカー
info.numbers-game.desc	"\n<indent=10>高額の賭けが行われるゲームで、地元のレースの結果に賭ける常連客が集まります。\n\n<b>必要条件:</b> <sprite name="skill gambling"><link="gambling-numbers">ナンバーズゲーム</link>、<sprite name="res cash"> 2000</indent>\n\nこの機能が導入されると、<link="regular-games">高額賭博ゲーム</link>として機能し、ギャンブルハウスに少なくとも<sprite name="res cash"> 1000の資金がある限り、常連客から平均で<sprite name="res cash"> 75の賭け金を受け取ります。常連客は増減し、負債がない場合には10%の確率で退場します。プレイ中には、5倍の賭け金を獲得する10%のチャンスがあります。\n\n<i><indent=30>「勝利のカードを持っているときは、常に公正にプレイすべきだ。」</i></indent> \n<indent=40>—オスカー・ワイルド</indent>"
info.card-tables.name	カードテーブル
info.card-tables.desc	<indent=10>高額の賭けを行うゲームで、常連客がさまざまなシンプルなカードゲームをプレイします。ゲームが頻繁に変わるため、ハウスエッジ（店の利益率）は低くなりますが、客席を埋めることができます。\n\n<b>必要条件:</b> <sprite name="skill gambling"><link="gambling-cards">カードゲーム</link>、<sprite name="res cash"> 1200</indent>\n\nこの機能をインストールすると、<link="regular-games">高額賭博</link>として機能し、ギャンブル場に最低でも<sprite name="res cash"> 750が用意されている限り、常連客から平均<sprite name="res cash"> 200の賭け金を集めることができます。常連客は出入りがあり、借金がない場合、20％の確率で毎ターン退席します。プレイ中に、彼らが賭け金の3倍を勝ち取る確率は10％です。\n\n<i><indent=30><i>勝っているときは、常に公正にプレイすべきだ。</i></indent> \n<indent=40>—オスカー・ワイルド</indent>
info.otb-parlor.name	場外馬券売場
info.otb-parlor.desc	<b>地域限定のギャンブル機能（一部の都市のみで利用可能）。</b>\n\n<indent=10>東海岸全域のレース結果に賭ける常連客を集める高額賭博ゲーム。\n\n<b>必要条件:</b> <sprite name="skill gambling"><link="gambling-secret-books">帳簿操作</link>、<sprite name="skill gambling"><link="gambling-high-rollers">ハイローラーの旅行企画</link>、<sprite name="res cash"> 5000</indent>\n\nこの機能をインストールすると、<link="regular-games">高額賭博</link>として機能し、ギャンブル場に最低でも<sprite name="res cash"> 3500が用意されている限り、常連客から平均<sprite name="res cash"> 200の賭け金を集めることができます。常連客は出入りがあり、借金がない場合、5%の確率で毎ターン退席します。プレイ中に、彼らが賭け金の20倍を勝ち取る確率は4％です。\n\n<i><indent=30><i>勝っているときは、常に公正にプレイすべきだ。</i></indent>\n <indent=40>—オスカー・ワイルド</indent>
info.blackjack-tables.name	ブラックジャックテーブル
info.blackjack-tables.desc	<indent=10>ブラックジャックをプレイする常連客を集める高額賭博ゲーム。大きな金の動きがこのゲームを揺れ動くものにし、利益が出やすくなりますが、損失をうまく処理できれば、常連客を借金まみれにすることができます。\n\n<b>必要条件:</b> <sprite name="skill gambling"><link="gambling-clean-money">資金洗浄</link>、<sprite name="skill gambling"><link="gambling-cards">カードゲーム</link>、<sprite name="res cash"> 3000</indent>\n\nこの機能をインストールすると、<link="regular-games">高額賭博</link>として機能し、ギャンブル場に最低でも<sprite name="res cash"> 2000が用意されている限り、常連客から平均<sprite name="res cash"> 625の賭け金を集めることができます。常連客は出入りがあり、借金がない場合、5%の確率で毎ターン退席します。プレイ中に、彼らが賭け金の15倍を勝ち取る確率は5％です。\n\n<i><indent=30><i>勝っているときは、常に公正にプレイすべきだ。</i></indent>\n <indent=40>—オスカー・ワイルド</indent>
info.table-games.name	テーブルゲーム
info.table-games.desc	<indent=10>さまざまな流行のゲームやテーブルトリックをプレイする常連客を集める高額賭博ゲーム。新鮮さに対する興味で人を惹きつけるため、厳しいオッズを設定しても問題にならないことが多い。\n\n<b>必要条件:</b> <sprite name="skill gambling"><link="gambling-tables">テーブルゲーム</link>、<sprite name="skill gambling"><link="gambling-clean-money">資金洗浄</link>、<sprite name="res cash"> 4000</indent>\n\nこの機能をインストールすると、<link="regular-games">高額賭博</link>として機能し、ギャンブル場に最低<sprite name="res cash"> 2800が用意されている限り、常連客から平均<sprite name="res cash"> 275の賭け金を集めることができます。常連客は出入りがあり、借金がない場合、5%の確率で毎ターン退席します。プレイ中に、賭け金の15倍を勝ち取る確率は5％です。\n\n<i><indent=30><i>「勝ち札を持っているときこそ、公正にプレイすべきだ。」</i></indent> \n<indent=40>—オスカー・ワイルド</indent>
info.roulette-wheels.name	ルーレット盤
info.roulette-wheels.desc	<indent=10>ルーレットでボールがどこに落ちるかに賭ける常連客を集める高額賭博ゲーム。操作が容易なため、すでに悪いオッズがさらに悪化する。\n\n<b>必要条件:</b> <sprite name="skill gambling"><link="gambling-clean-money">資金洗浄</link>、<sprite name="skill gambling"><link="gambling-secret books">帳簿改ざん</link>、<sprite name="res cash"> 7500</indent>\n\nこの機能をインストールすると、<link="regular-games">高額賭博</link>として機能し、ギャンブル場に最低<sprite name="res cash"> 3500が用意されている限り、常連客から平均<sprite name="res cash"> 225の賭け金を集めることができます。常連客は出入りがあり、借金がない場合、0.5%の確率で毎ターン退席します。プレイ中に、賭け金の90倍を勝ち取る確率は1％です。\n\n<i><indent=30><i>「勝ち札を持っているときこそ、公正にプレイすべきだ。」</i></indent>\n <indent=40>—オスカー・ワイルド</indent>
info.high-rollers-parlor.name	ハイローラー応接室
info.high-rollers-parlor.desc	<b>一部の都市でのみ利用可能な地域限定のギャンブル機能。</b>\n\n<indent=10>豪華な内装に囲まれ、思いついたゲームで勝負をする常連客を集める高額賭博ゲーム。オッズはまあまあですが、この客層ならお金は常に良い結果を生みます。\n\n<b>必要条件:</b> <sprite name="skill gambling"><link="gambling-secret-books">帳簿改ざん</link>、<sprite name="skill gambling"><link="gambling-high-rollers">ハイローラー専用ツアー</link>、<sprite name="res cash"> 10000</indent>\n\nこの機能をインストールすると、<link="regular-games">高額賭博</link>として機能し、ギャンブル場に最低<sprite name="res cash"> 7500が用意されている限り、常連客から平均<sprite name="res cash"> 500の賭け金を集めることができます。常連客は出入りがあり、借金がない場合、0.0005%の確率で毎ターン退席します。プレイ中に、賭け金の15倍を勝ち取る確率は5％です。\n\n<i><indent=30><i>「勝ち札を持っているときこそ、公正にプレイすべきだ。」</i></indent> \n<indent=40>—オスカー・ワイルド</indent>
info.poker-game.name	ポーカーゲーム
info.poker-game.desc	<indent=10>プレイヤーたちが競い合うポーカーゲームを定期的に開催する集まりを形成します。場所とチップを提供するため、結果に関わらずあなたが勝ち分の一部を得ます。\n\n<b>必要条件:</b> <sprite name="res cash"> 5000</indent>\n\nこの機能をインストールすると、<link="regular-games">レイク</link>として機能し、ギャンブル場に最低<sprite name="res cash"> 300が用意されている限り、常連客から平均<sprite name="res cash"> 125の賭け金を集めます。常連客は出入りがあり、借金がない場合、毎ターン1%の確率で退席します。プレイヤーの特性が勝敗を左右し、毎週シャッフルで動く金額の10%を手に入れることができます。最低4席が提供されます。\n\n<i><indent=30><i>「勝ち札を持っているときこそ、公正にプレイすべきだ。」</i></indent> \n<indent=40>—オスカー・ワイルド</indent>
info.dice-game.name	ダイスゲーム
info.dice-game.desc	<indent=10>プレイヤーたちが集まり、サイコロゲームを競い合う集まりを形成します。設定費用はそれほどかかりませんが、大きな賭けを期待するのも難しいでしょう。\n\n<b>必要条件:</b> <sprite name="skill gambling"><link="gambling-tables">テーブルゲーム</link>、<sprite name="res cash"> 1500</indent>\n\nこの機能をインストールすると、<link="regular-games">レイク</link>として機能し、ギャンブル場に最低<sprite name="res cash"> 750が用意されている限り、常連客から平均<sprite name="res cash"> 75の賭け金を集めます。常連客は出入りがあり、借金がない場合、毎ターン20%の確率で退席します。プレイヤーの特性が勝敗を左右し、毎週シャッフルで動く金額の10%を手に入れることができます。最低2席が提供されます。\n\n<i><indent=30><i>「勝ち札を持っているときこそ、公正にプレイすべきだ。」</i></indent>\n <indent=40>—オスカー・ワイルド</indent>
info.baccarat-salon.name	バカラ・サロン
info.baccarat-salon.desc	<b>特定の都市でのみ利用可能な地域限定のギャンブル機能。</b>\n\n<indent=10>バカラをプレイする常連客を集めるレイクゲーム。テーブルに座るプレイヤーは、格式高いヨーロッパのゲームであるため、大きな金額を賭けることを厭わないタイプが多い。そのため、他の競技ゲームと同じ割合であっても、より大きな取り分が期待できる。\n\n<b>必要条件:</b> <sprite name="skill gambling"><link="gambling-secret-books">隠された帳簿</link>、<sprite name="skill gambling"><link="gambling-high-rollers">ハイローラーのジャンクット</link>、<sprite name="res cash"> 7500</indent>\n\nこの機能をインストールすると、<link="regular-games">レイク</link>として機能し、ギャンブル場に最低<sprite name="res cash"> 4000が用意されている限り、常連客から平均<sprite name="res cash"> 75の賭け金を集めます。常連客は出入りがあり、借金がない場合、毎ターン5%の確率で退席します。プレイヤーの特性が勝敗を左右し、毎週シャッフルで動く金額の10%を手に入れることができます。最低8席が提供されます。\n\n<i><indent=30><i>「勝ち札を持っているときこそ、公正にプレイすべきだ。」</i></indent> \n<indent=40>—オスカー・ワイルド</indent>
info.bar-small.name	小さなバー
info.bar-small.desc	\n<indent=10>ギャンブルハウスに来る全ての客の財布を緩める機能。単独では利益を生まないが、他の機能を少しだけ儲かりやすくする。\n\n<b>必要条件:</b>\n\n</link><sprite name="skill gambling"><link="gambling-service">洗練されたサービス</link>、または<sprite name="skill gambling"><link="gambling-staff">配慮あるスタッフ</link>、<sprite name="res cash"> 1500</indent>\nこの機能をインストールすると、ギャンブルハウス内の他の機能に影響を与えます。このバーが設置されている限り、プレイヤーは通常よりも最大で10%多く賭ける意欲を持つようになります。\n\n<i><indent=30><i>「勝ち札を持っているときこそ、公正にプレイすべきだ。」</i></indent>\n <indent=40>—オスカー・ワイルド</indent>
info.telegraph-machine.name	電信機
info.telegraph-machine.desc	<b>一部の都市でのみ利用可能な賭博場の出し物</b>\n\n<indent=10>世界中のレース結果を知ることができる驚異的な技術で、レースマニアが金を落とすゲームがさらに増えた。\n\n<b>必要なもの：</b>\n<sprite name="skill gambling"><link="gambling-secret-books">不正会計</link>、<sprite name="skill gambling"><link="gambling-high-rollers">ハイローラー・ジャンケット</link>、<sprite name="skill gambling"><link="gambling-staff">気の利くスタッフ</link>、<sprite name="res cash">300</indent>\n\n賭博場に電信機が設置されていると、場外馬券売場に常連客を1人ずつ座らせることができる様になり、その常連客は10％多く賭ける様になる。\n\n<i><indent=30><i>勝ち札を持っているときは、常にフェアなプレーを心がけなければならない。</i></indent>\n<indent=40>ーオスカー・ワイルド</indent>
info.card-parlor.name	カード・パーラー
info.card-parlor.desc	<indent=10>カードゲーム専用の部屋が増えれば、常連客の席も増える。\n\n<b>必要なもの：</b>\n<sprite name="skill gambling"><link="gambling-cards">カードゲーム</link>、<sprite name="skill gambling"><link="gambling-clean-money">資金洗浄</link>、<sprite name="skill gambling"><link="gambling-furnishing">洗練された仕上がり</link>、<sprite name="res cash">5000</indent>\n\nカードパーラーを賭博場に設置していると、カードゲームの常連客用の席が2つ追加される。\n\n<i><indent=30><i>勝ち札を持っているときは、常にフェアなプレーを心がけなければならない。</i></indent>\n<indent=40>ーオスカー・ワイルド</indent>
info.plush-carpets.name	プラッシュ・カーペット
info.plush-carpets.desc	<indent=10>実用性はあまり無いが、あなたの賭博場が注目されることは間違いない。\n\n<b>必要なもの：</b>\n<sprite name="skill gambling"><link="gambling-cards">カードゲーム</link>、<sprite name="skill gambling"><link="gambling-numbers">ナンバーゲーム</link>、<sprite name="skill gambling"><link="gambling-tables">テーブルゲーム</link>、<sprite name="skill gambling"><link="gambling-furnishing">洗練された仕上がり</link>、<sprite name="res cash">2500</indent>\n\nプラッシュ・カーペットを賭博場に設置していると、遠方から客が足を運ぶ様になるので潜在顧客が増加する。\n\n<i><indent=30><i>勝ち札を持っているときは、常にフェアなプレーを心がけなければならない。</i></indent>\n<indent=40>ーオスカー・ワイルド</indent>
info.imported-furniture.name	輸入家具
info.imported-furniture.desc	<indent=10>派手なものは高価かもしれないが、贅沢に遊べるのであれば、遠方からでも客は気持ちよく足を運ぶだろう。\n\n<b>必要なもの</b>\n<sprite name="skill gambling"><link="gambling-furnishing">洗練された仕上がり</link>、<sprite name="res cash">3500</indent>\n\n輸入家具を賭博場に設置していると、遠方から客が足を運ぶ様になるので潜在顧客が増加する。\n\n<i><indent=30><i>勝ち札を持っているときは、常にフェアなプレーを心がけなければならない。</i></indent>\n<indent=40>ーオスカー・ワイルド</indent>
info.uniforms.name	制服を着た係員
info.uniforms.desc	<indent=10>専門的で威圧感のないスタッフは、あなたが犯罪組織を運営していることを客に忘れさせる。そういう安心感は、債務整理をするときに役立つ。\n\n<b>必要なもの：</b>\n<sprite name="skill gambling"><link="gambling-cards">カードゲーム</link>、<sprite name="skill gambling"><link="gambling-numbers">ナンバーゲーム</link>、<sprite name="skill gambling"><link="gambling-tables">テーブルゲーム</link>、<sprite name="skill gambling"><link="gambling-service">心地よいサービス</link>、<sprite name="res cash">2500</indent>\n\n賭博場に制服を着た係員を配置していると、常連客の債権額を大きくし、より早く返済してもらうことが可能となる。\n\n<i><indent=30><i>勝ち札を持っているときは、常にフェアなプレーを心がけなければならない。</i></indent>\n<indent=40>ーオスカー・ワイルド</indent>
info.valet-parking.name	バレットパーキング
info.valet-parking.desc	<b>一部の都市でのみ利用可能な出し物</b>\n\n<indent=10>駐車の必要が無くなれば誰もが幸せになる。常連客や自動車で訪れる客が増えるということはより多くの金が流れてくるということだ。\n\n<b>必要なもの：</b>\n<sprite name="skill gambling"><link="gambling-high-rollers">ハイローラー・ジャンケット</link>、<sprite name="skill gambling"><link="gambling-staff">気の利くスタッフ</link>、<sprite name="res cash">5000</indent>\n\n賭博場にバレットパーキングを導入していると、より多くの常連客がハイステークスゲームに参加し、多くの人々がより遠くから訪れるようになり、潜在的顧客を増加させる。\n\n<i><indent=30><i>勝ち札を持っているときは、常にフェアなプレーを心がけなければならない。</i></indent>\n<indent=40>ーオスカー・ワイルド</indent>
info.chandeliers.name	最新の照明装置
info.chandeliers.desc	<b>一部の都市でのみ利用可能な出し物</b>\n\n<indent=10>耐久性があり、ランニングコストの安い素材を使用することで、諸経費を削減することができる。\n\n<b>必要なもの：</b>\n<sprite name="skill gambling"><link="gambling-high-rollers">ハイローラー・ジャンケット</link>、<sprite name="skill gambling"><link="gambling-furnishing">洗練された仕上がり</link>、<sprite name="res cash">2500</indent>\n\n賭博場に最新の照明装置を設置していると、設備の運用コストを削減できる。\n\n<i><indent=30><i>勝ち札を持っているときは、常にフェアなプレーを心がけなければならない。</i></indent>\n<indent=40>ーオスカー・ワイルド</indent>
info.rake-games.name	レーキ・ゲーム
info.rake-games.desc	<indent=10>プレイヤーたちがチャンスゲームで互いに競い合うための場を設ける。賭場側はゲームに関与しないが、何が起きても賞金の一部を手数料として受け取る。</indent>\n\n<i><indent=30><i>勝ち札を持っているときは、常にフェアなプレーを心がけなければならない。</i></indent>\n<indent=40>ーオスカー・ワイルド</indent>
info.low-stakes.name	ロウステークス・ゲーム
info.low-stakes.desc	<indent=10>この賭博形式は参加費が低い。つまり、何度も継続的に賭博場へ足を運ぶことに興味のない通りがかりの人を惹きつける。受動的な収入源として有効だが、その収益はカジノの影響力の範囲内に潜在顧客がいるかどうかに大きく依存する。</indent>\n\n<i><indent=30><i>勝ち札を持っているときは、常にフェアなプレーを心がけなければならない。</i></indent>\n<indent=40>ーオスカー・ワイルド</indent>
info.regular-games.name	ハイステークス・ゲーム
info.regular-games.desc	<indent=10>参加費が高く高配当のゲームは、筋金入りのギャンブラーを招き、大勝ちするか多額の借金を背負うまでギャンブル場の常連客として遊んでもらう。他のゲームに比べれば、常連客はつけで勝負しているのでそれほど儲かるわけではないが、借金している人がたくさんいることは、別の形で利益を生む。</indent>\n\n<i><indent=30><i>勝ち札を持っているときは、常にフェアなプレーを心がけなければならない。</i></indent>\n<indent=40>ーオスカー・ワイルド</indent>
tut.newgame.firstname	ジョン
tut.newgame.lastname	スミス
tut.newgamepopup.name	<b>{name}</b>\n\n{ageinfo}
tut.newgamepopup.text1	あなたはついに大都市についた: <b>{cityname}.</b>
tut.newgamepopup.text2	時は1920年、金ぴか時代の幕開け。国は繁栄しているが、分裂している。禁酒法が制定され、国内でのアルコール飲料の販売、製造、輸送が違法となった。この法律は、禁酒運動を支持しない都市住民や移民に対する攻撃と見なされている。もちろん、この法律を真に受ける人はいない。違法な酒場や酒類販売業があちこちにでき、警察を説得して目をつぶらせることも簡単だった。
tut.newgamepopup.text3.m	あなたはこの人種のるつぼに、わずかなお金と家族のコネクションを持ってやってきたわけです。あなたは叔父<b>{name}</b>のところに滞在しています。彼はこの街で小さなビジネスをしていて、あなたに手ほどきをしてくれます。
tut.newgamepopup.text3.f	あなたはこの人種のるつぼに、わずかなお金と家族のコネクションを持ってやってきたわけです。あなたは叔母<b>{name}</b>のところに滞在しています。彼はこの街で小さなビジネスをしていて、あなたに手ほどきをしてくれます。
tut.newgamepopup.text4	しかし、あなたは家業の店を経営したいとは思っていません。この状況は、あなたのようなリスクを恐れない人にとって、チャンスに満ちているのです。
tut.newgamepopup.text5	電車を降り、高層ビル群や果てしない人混みを目にしたとき、あなたはすでに「これは何か素晴らしいことの始まりだ」と感じていることでしょう。
tut.fr.button-continue	続ける
tut.fr.button-waiting	待機中…
tut.fr.button-understood	了解
tut.fr.button-agreed	同意
tut.fr.button-skip	このレッスンをスキップ
tut.fr.button-hint-ok	OK
tut.fr.button-hint-skip	二度と表示しない
tut.fr.header	レッスン {num}: {title}  <color=#aaaaaa>({i}/{n})</color>
tut.fr.missiondone.m	チュートリアルミッションの1つが終了しました\n\n詳しくは叔父{fr}をご覧ください。詳しくは左のミッション一覧をご覧ください。
tut.fr.missiondone.f	チュートリアルミッションの1つが終了しました\n\n詳しくは叔母{fr}を訪ねてください。詳しくは左のミッション一覧をご覧ください。
tut.lesson-1.title	周りを見てみよう
tut.lesson-1.1.m	<i>電車を降りると {fr} が近づいてくる。</i>\n{name}、私の愛する甥！ 会えて嬉しいよ。 私たちの近所はどうみえる？ それほど多くはないように見えるかもしれないが、間違いなくここは私たちのものだ。\n案内するよ！
tut.lesson-1.1.f	<i>電車を降りると {fr} が近づいてくる。</i>\n{name}、私の愛する姪！ 会えて嬉しいよ。 私たちの近所はどうみえる？ それほど多くはないように見えるかもしれないが、間違いなくここは私たちのものだ。\n案内するよ！
tut.lesson-1.2	"最初に学ぶことは周りを見回すことだ！\n<b>W， A， S， D</b> キーを押すと周りを見回すことができる。<sprite name="tut mouse left"><b>左クリック</b>したままドラッグすることもできる。"
tut.lesson-1.3	"次にズームインおよびズームアウトするには、<b>FまたはR</b>キーを使用するか、<sprite name="tut mouse middle"><b>マウスホイール</b>を使用するんだ。試してみてくれ。"
tut.lesson-1.4	"最後にマップを回転させるには、<b>Q または E</b>キーを使用するんだ。もしくは<sprite name="tut mouse middle"><b>マウス真ん中ボタン</b>をクリックしてドラッグしてもいい。"
tut.lesson-1.5	"他には <sprite name="tut mouse right"> <b>右クリック</b>または <b>ESC</b> キーでダイアログとポップアップウィンドウ（このダイアログウィンドウを除く）を閉じるために使用できる。"
tut.lesson-2.title	おまえは誰だ？
tut.lesson-2.1	この青いマーカーはゲームマップ上で<b>あなた</b>を表します。あなたが運転するにつれてあなたの車に追尾します。\nクリックして選択してください。
tut.lesson-2.2	明るいオレンジ色が見えますか？これはさまざまなアクションを実行するために<b>選択</b>していることを示しています。
tut.lesson-2.3	選択した人に関するすべての情報がUIの右側に表示されます。\n順番に見ていきましょう。
tut.lesson-2.4	最初にマーカーと同じ顔写真ですので、誰なのかを識別するのは簡単です。
tut.lesson-2.5	2つ目は、運転する車です。
tut.lesson-2.6	"その隣には、<sprite name="ui action pts"> アクションポイントがあり、1ターンにどれだけのことができるかを決定します。それと…"
tut.lesson-2.7	"<sprite name="ui movement pts">移動ポイント、これは1ターンに走れる距離を決めるものです。\n車で移動しながら色々なことをやっているうちに使い切ってしまうと思います。"
tut.lesson-2.8	すぐ下には乗っている車に積んでいる物の内容が表示されます。
tut.lesson-2.9	また、顔写真の下には、その人の特徴や過去の経験などが表示され、マウスを乗せると詳細が表示されます。\nさあ試してみて！
tut.lesson-2.10	最後に、車の上にあるマーカーをクリックするか、画面右上にある構成員カードをクリックするか、<b>1</b>キーを押して構成員を選択することができます。\n1キーを1回押すとクルーが選択され、素早く2回押すとカメラも自動で移動します。試してみてください！\n<b>1</b>キーを押す、またはクリックで操作してください。
tut.lesson-3.title	車、現金、その他
tut.lesson-3.1	では、現金と車について見てみましょう。
tut.lesson-3.2	ここでは建物や乗り物の中にある<b>現金</b>の残高を見ることができます。\nマウスを乗せると、どの場所にいくらあるのか、また前ターンにいくら得をしたのか、損をしたのかがわかります。
tut.lesson-3.3	次はあなたの<b>車両</b>です : <sprite name="ui car"> 車と <sprite name="ui truck">トラック。\n最大数を増やすには、駐車場か整備工場が必要です。
tut.lesson-3.4	そしてその左側には、あなたの<sprite name="ui corner"><b>コーナー</b>と<sprite name="ui peep"><b>構成員の人数</b>が表示されています。\n今あなたの構成員はあなた1人だけです。もう少しテリトリーを広げれば、もっと多くの人を雇うことができるようになります。\nマウスオーバーすると詳細が表示されます。
tut.lesson-3.5	左端にあるこれらのボタンは、様々なオーバーレイや情報ダイアログを表示します。これらのボタンについては、後ほど紹介します。
tut.lesson-3.6	右上を見ると現在の日付が表示されています。今日は{date}です。\nこれはターン制のゲームで、1ターンは{days}日続きます。
tut.lesson-3.7	"<sprite name="ui action pts">アクションポイントや<sprite name="ui movement pts">移動ポイントが足りなくなったら、<b>次のターン</b>ボタンを押して次のターンに進みましょう。\n試しに今押してみてください。それが終わったら続きです。"
tut.lesson-3.8	ご覧の通り、日付は{date}に進みました。\nターンのたびに<sprite name="ui action pts">アクションポイント、<sprite name="ui movement pts">移動ポイントが補充されます。
tut.lesson-4.title	隠れ家
tut.lesson-4.1	この建物はあなたの<b>隠れ家</b>になります。\nマーカーをクリックすると、建物情報ダイアログが表示されます。
tut.lesson-4.2.m	外見上は普通の会社で、私やあなたの叔父{fr}が経営しています。\nしかし内部には十分な収納スペースがあり、<b>新しい事業</b>を始めるためのスペースもあります。
tut.lesson-4.2.f	外見上は普通の会社で、私やあなたの叔母{fr}が経営しています。\nしかし内部には十分な収納スペースがあり、<b>新しい事業</b>を始めるためのスペースもあります。
tut.lesson-4.3	順番に見ていきましょう。 まず、この<b>ビジネスタブ</b>をクリックします。\nダイアログウィンドウの横にある青いタブです。
tut.lesson-4.4	これぞ正統派ビジネス。これはあなたがどんな事業を立ち上げようとも、良い隠れ蓑になるでしょう。
tut.lesson-4.5	次に<b>ストレージ</b>タブをクリックします。
tut.lesson-4.6	このパネルは地下に保管されているものです。禁酒法以前のお酒がたくさんあります！\nもう少しで有効活用できそうだ。
tut.lesson-4.7	次に<b>バックルームタブ</b>をクリックします。
tut.lesson-4.8	このパネルは、建物の奥に設置されているものが表示されます。\n今はまだ空っぽですが、新しい事業を始めることもできます。
tut.lesson-4.9	次に<b>コーナータブ</b>をクリックします。
tut.lesson-4.10	このダイアログは、現在いる<b>コーナー</b>に関する情報を表示します。\nコーナーはテリトリーの基本単位で、すべての建物はどこかのコーナーに属しており、コーナーは誰かのテリトリーに属している可能性があります。
tut.lesson-4.11	このコーナーにあるビジネスです。\nこのコーナーに行くと、そこにあるすべてのビジネスを訪問することができます。
tut.lesson-4.12	これは、このコーナーでのあなたの<b>リスペクトレベル</b>と、このコーナーで知られている他の人たちからのリスペクトを示しています。\n私があなたのことを人に話したおかげで、あなたはとてもリスペクトされています。結果としてこのコーナーはあなたのテリトリーの一部となりました。
tut.lesson-4.13	逆に、このコーナーでの<b>ヒートレベル</b>です。マウスオーバーすると詳細が表示されます。\n違法行為はヒートが上昇し、警察の注意を引きます。
tut.lesson-4.14	うわさをすれば影、私たちがいる<b>警察管区</b>の情報です。マウスオーバーすると詳細が表示されます。\n今のところ静かなものです。そして静かであることは、ビジネスにとって良いことです。
tut.lesson-4.15	よし、これで終わりにして、私の隠れ家に戻ろう。
tut.lesson-4.16	次に、私の顔写真があるタブをクリックします。
tut.lesson-4.17.m	これは私だ、あなたの叔父 {fr}。 両親には私があなたを引き取って、この街での生活をスタートさせる手助けをすると伝えてあるよ。
tut.lesson-4.17.f	これは私だ、あなたの叔母 {fr}。 両親には私があなたを引き取って、この街での生活をスタートさせる手助けをすると伝えてあるよ。
tut.lesson-4.18	このダイアログを一旦閉じましょう。
tut.lesson-4.19	ダラダラ喋りすぎてしまったな。少し歩こうか。
tut.lesson-5.title	訪問する
tut.lesson-5.1	このビジネスを見てください。私たちと同じコーナーにあるんだ。ちょっと行ってみようか。\nマーカーをクリックすると、オーナーを訪問することができます。
tut.lesson-5.2	マーカーをクリックすると、{bizname}を経営する{name}さんを訪問します。\nさっそく話を聞いてみようと思いますが、まずは彼らのことをもっと知りましょう。
tut.lesson-5.3	ポートレートにマウスを乗せると、その人物に関するさまざまな情報を得ることができます。\nその人の特徴や気質を知っておくと、相手との付き合い方を工夫できるでしょう。民族性も重要で、同じ民族の人はより親しみやすいでしょう。
tut.lesson-5.4	このメーターは、相手があなたに対してどのような感情を抱いているかを示しています。マウスオーバーすると詳細が表示されます。
tut.lesson-5.5	この人はあなたにいくつも<b>恩義</b>があるようです。ただどう借りを返してもらうかは慎重に考えてください、簡単に得られるものではないでしょう。
tut.lesson-5.6	次にこちらに注目してください。ここから時には親しげに会話をすることができます。\n左側に相手が話していることが表示され、右側でこちらの返答が選択できます。
tut.lesson-5.7	試しに最初の選択肢を選んで、売買について質問してください。
tut.lesson-5.8	何かを買いたい、売りたいと思ったとき、このような方法があります。\nしかし、もうひとつ確認すべきことがあります。
tut.lesson-5.9	彼らの知り合いを見てみよう。画面左上の「コネクション」ボタンをクリックしてください。
tut.lesson-5.10	このダイアログには、その人の個人情報や、最も重要である私たちが知っているすべてのコネクション（当面は制限付き）が表示されます。
tut.lesson-5.11	コネクションはあなたにとって重要なものになります。\nお酒を買うにも、売るにも、あなたのことを好きでいてくれる人、信頼してくれる人を知っておかなくてはなりません。
tut.lesson-5.12	必要なものを得るためには、そのコネクションを得る必要があるのです。でも、それは後回しにしましょう。\nとりあえずこのダイアログを閉じてください。
tut.lesson-5.13	気分転換にドライブでもいこうか？お前が運転してくれ。
tut.lesson-6.title	周辺をドライブする
tut.lesson-6.1	これも近くのビジネスで、1つ先のコーナーにあります。\nそのマーカーをクリックして、何が起こるか見てみましょう。
tut.lesson-6.2	ご覧のように、いくつかの情報は表示されますが、遠すぎて訪問することはできません。\n実際に車で行って、オーナーと話をする必要があります。
tut.lesson-6.3	これはよくあることで、物事を成し遂げるためには、あなたやあなたの部下が実際にそこに行って、誰かと話をする必要があります。
tut.lesson-6.4	では車で行ってみましょう。自分のマーカーをクリックして、アクティブな状態にします。
tut.lesson-6.5	そして今度は、そのビジネスに最も近い場所を<b>右クリック</b>してください。
tut.lesson-6.6	もし正しい場所にドライブできなかったとしても大丈夫です。自分が選択されていることを確認し、ドライブしたい場所を右クリックしてください。
tut.lesson-6.7	走行中にビジネスのマーカー色が変わります。\n同じコーナーのお店が緑になったら、そのお店を訪問できることを示します。\n逆に、遠すぎる企業は濃いグレーになっています。
tut.lesson-6.8	さて、そんなこんな所でいいか、課題を用意したよ。
tut.lesson-6.9.m	いとこの{name}を見つけるまでドライブしてください。 彼は近くで{bizname}を経営しています。地下に隠した違法な在庫を整理してくれるだろう。\nただ{bizname}がどこにあるかは教えません、それが最初の仕事です。しかしこの近くにはあります。
tut.lesson-6.9.f	いとこの{name}を見つけるまでドライブしてください。 彼女は近くで{bizname}を経営しています。地下に隠した違法な在庫を整理してくれるだろう。\nただ{bizname}がどこにあるかは教えません、それが最初の仕事です。しかしこの近くにはあります。
tut.lesson-6.10.m	彼を見つけて訪問してください。今は一人にしておくよ。\nまた、移動ポイントが足りなくなったら、<b>「次のターン」</b>ボタンを押すだけです。
tut.lesson-6.10.f	彼女を見つけて訪問してください。今は一人にしておくよ。\nまた、移動ポイントが足りなくなったら、<b>「次のターン」</b>ボタンを押すだけです。
tut.lesson-6.11	<i>({name}を{bizname}で見つけるのを待っています。車で行って会話を始めてください。)</i>
tut.lesson-7.title	購入と売却
tut.lesson-7.1.m	よし、いとこの{name}を見つけたな。では、売買について聞いてみてくれ。
tut.lesson-7.1.f	よし、いとこの{name}を見つけたな。では、売買について聞いてみてくれ。
tut.lesson-7.2.m	私たちが隠し持っている <sprite name="res home-brew" tint> 自家製ビールを売ればいいようだな。
tut.lesson-7.2.f	私たちが隠し持っている <sprite name="res home-brew" tint> 自家製ビールを売ればいいようだな。
tut.lesson-7.3	ただあなたの車には何もないな。品物を持って戻ってくる必要があるんだ。\nこのダイアログを一旦閉じよう。
tut.lesson-7.4	車で隠れ家に戻り、自家製ビールを持ってこよう。
tut.lesson-7.5	<i>(隠れ家に戻るのを待っています)</i>
tut.lesson-7.6	隠れ家のダイアログを開き、ストレージのタブを選択します。
tut.lesson-7.7	<i>(ストレージパネルの表示を待っています。)</i>
tut.lesson-7.8	左側が店の中身、右側が自分の車のトランクです。店内の <sprite name="res home-brew" tint> 自家製ビールをクリックし、20個の壺を車に積み込みます。
tut.lesson-7.9	よし、これでいいです。タブを閉じてください。
tut.lesson-7.10.m	{name} の所に戻って、 <sprite name="res home-brew" tint> 自家製ビールを彼が欲しがるだけ売ってきてくれ。それが終わるまで待っているよ。
tut.lesson-7.10.f	{name} の所に戻って、 <sprite name="res home-brew" tint> 自家製ビールを彼女が欲しがるだけ売ってきてくれ。それが終わるまで待っているよ。
tut.lesson-7.11	<i>({name} に <sprite name="res home-brew" tint> 自家製ビールを売却するまで待っています)</i>
tut.lesson-8.title	役に立つ友人
tut.lesson-8.1.m	では人間関係や紹介の話をしましょう。この街で物事を成し遂げるためには、住んでいる人々について知っておく必要があります。\nいとこの{name}を訪ねて、会話を始めてみてください。
tut.lesson-8.1.f	では人間関係や紹介の話をしましょう。この街で物事を成し遂げるためには、住んでいる人々について知っておく必要があります。\nいとこの{name}を訪ねて、会話を始めてみてください。
tut.lesson-8.2	左上を見ると、{name}との関係がずいぶん改善されたことがわかります。\n人と人との取引は人間関係を良くします、特にそれが違法な取引であればなおさらです。
tut.lesson-8.3	人間関係が改善されると、<sprite name="ui tickets">恩義を集め始めます。\n{name}はあなたを高く評価しているため、<sprite name="ui tickets">を使うことができます。
tut.lesson-8.4	恩義を使ってみよう。{name}との会話で、 <sprite name="ui tickets">恩義や助け合いについて話すには、2番目の選択肢を選んでください。
tut.lesson-8.5	次に最初の選択肢を選んでみましょう。同じような商品も購入している人の <sprite name="ui social biz intro"> 紹介を求めます。
tut.lesson-8.6	{name}の友達の紹介されます。 正式に紹介してもらうためには1つの<sprite name="ui tickets">恩義を使用してください。
tut.lesson-8.7.m	いいね、{friendname}を紹介してもらえたんだな！\n友人である{name}の紹介であるため、彼はすでにあなたを信頼しており、違法な商品などについても喜んで話してくれることでしょう。
tut.lesson-8.7.f	いいね、{friendname}を紹介してもらえたんだな！\n友人である{name}の紹介であるため、彼女はすでにあなたを信頼しており、違法な商品などについても喜んで話してくれることでしょう。
tut.lesson-8.8	信頼できる友人からの紹介は、ビジネスの基礎になります。\n自分のネットワークに目を配り、できる限り紹介を受けるようにしましょう。
tut.lesson-8.9.m	今度は{friendname}のところに車で行って、<sprite name="res home-brew" tint>自家製ビールも売ってきてくれ。やり方はわかっているはずだ。終わったらまた会おう。
tut.lesson-8.9.f	今度は{friendname}のところに車で行って、<sprite name="res home-brew" tint>自家製ビールも売ってきてくれ。やり方はわかっているはずだ。終わったらまた会おう。
tut.lesson-8.10	<i>(追加で<sprite name="res home-brew" tint>自家製ビールを売るのを待っています。)</i>
tut.lesson-9.title	探索
tut.lesson-9.1	今度はこっちを見てくれ。\nこのマーカーに<sprite name="biz unscoped">のアイコンが付いているのが見えるか？ それは、まだ内容が判明していないビジネスだ。
tut.lesson-9.2	そこで何が行われているかはわからないが、調べることはできる。\nマーカーが青になったら、その角まで行ってみてくれ。\nそこで、<sprite name="biz unscoped">マーカーをクリックすれば調査できる。待っているよ。
tut.lesson-9.3	あなたは時間をかけて街角を歩き、人の出入りを観察したことで、1<sprite name="ui action pts">アクションポイントを消費することになる。\nその結果それが<b>{bizname}</b>という名前であることがわかった。何をしているのか画面上部の通知にマウスオーバーすれば、すべての詳細を見ることができるようになったぞ。
tut.lesson-9.4	街を探索し始めると、最初はすべての企業が未知数だ、どの企業を開拓するかはおまえ次第だ。
tut.lesson-9.5	ここは大都会だ、ちょっと足を伸ばしてみるのもいいかもな。
tut.lesson-9.6	未踏の地はセピア色で表示され、どのようなビジネスが行われているのか分からない。\nコーナーを探検して初めて、そこに何があるのかわかるぞ。
tut.lesson-9.7	"さあ、この未知のコーナーに車を走らせるのだ。\nただし、注意点として、これは<sprite name="ui movement pts">移動ポイントを大量に消費します! もし足りなければ、次のターンに進むことを忘れないでください。\n新しいコーナーを探検してきてください、私は待っています。"
tut.lesson-9.8	このように地図探索の仕組みはこうなっている。そして新しいビジネスを発見し、それを調査し、オーナーと話し、何を売り買いしているのかを知ることができます。\nただ友人からの紹介があれば、最初から信頼を得られた状態となるため良い方法と言えます。全く知らない人の信頼を得るのは非常に大変です。
tut.lesson-9.9	よし、おまえは物覚えがいいな。\nでは今度は別の仕事をお願いしよう。\n金庫に隠したビールを覚えているか？売ってしまえ、全部だ！その金で何か新しいビジネスを始めるんだ、ビール工場とか？酒場とか？\nだから{name}や他買ってくれる人にもっと売ってみて、もし紹介を受けられそうならそれに乗ってみてくれ。\n合計で<b>{amt}</b>になるまで待っているよ、続きはそれからだ。
tut.lesson-9.10	大盛況じゃないか。\nこれで資金ができただろう、この街で新しい生活を始めることができそうだな。
tut.lesson-10.title	事業
tut.lesson-10.1	では、<b>事業</b>について説明するぞ。この街で本当に儲かるのは、自分たちで違法な酒を製造して売ることだ。\n禁酒法では、酒の製造と販売が違法とされ、そのため非常に大きな利益を得ることができた。\n捕まらない限りはね。
tut.lesson-10.2	新しい事業を立ち上げるには、自分で管理できる建物とその裏にある空きスペースが必要だ。\n幸い隠れ家の裏手には十分なスペースがあるから、そこに新しい事業を作ることができそうだ。\n車で隠れ家に戻ろう。
tut.lesson-10.3	よし。まずこの現金を少し下ろしてくれ。\n隠れ家のマーカーをクリックし、ダイアログを開きます。次にストレージタブに切り替えます。
tut.lesson-10.4	あなたの車から隠れ家にたくさんの現金を移動します。 <b>ctrl</b>キーと<b>shift</b>キーを使用して、現金とリソースをまとめて移動できることを忘れないでください。\n隠れ家に<b>{amt}</b>が移動されるまで待っているよ。
tut.lesson-10.5	素晴らしい。では、空のバックルームタブに切り替えてくれ。
tut.lesson-10.6	さっき話していたバックルームを利用できそうだ。'新規事業'ボタンを押してくれ。
tut.lesson-10.7	以上が、設定できるさまざまな操作です。\nこれらは<i>今</i>、あなたが実行するできるものだけです。将来的にはもっと多くのことを学ぶことになるだろうが、今あなたが知っているのはいくつかのものを作る方法だけです。
tut.lesson-10.8	ビールに興味がある人が何人かいるので、<b>自家製ビール</b>の事業を構築して、簡単に流通させることができるようにしましょう。\n事業が選択されていることを確認し、'建築'ボタンを押します。
tut.lesson-10.9	素晴らしい。運用開始まで数ターンかかる。その間にどのように動作するかの概要を説明しよう。
tut.lesson-10.10	ここでは、醸造所が<b>消費</b>するのは麦芽シロップと空の陶器の壺であり、それによって<b>自家製ビールで満たされた壺</b>を生産します。\n各要素にマウスを移動させると、詳細情報を確認できます。
tut.lesson-10.11	それに、倉庫には十分な麦芽シロップがあるけど、陶器の壺が足りない！もっと買いに行かなきゃ、このままじゃこの事業は大したことにならないよ。
tut.lesson-10.12	また、将来的に資金と人員が増えたら、この業務にマネージャーを配置したり、アップグレードや拡張を導入したりすることも検討するといい。そうすれば利益率が格段に上がるぞ。
tut.lesson-10.13.m	叔父の力を借りて、新しい酒造りを始めるなんて最高じゃないか。ご両親も喜んでいることだろう。そうだご両親に手紙を書こう。
tut.lesson-10.13.f	叔母の力を借りて、新しい酒造りを始めるなんて最高じゃないか。ご両親も喜んでいることだろう。そうだご両親に手紙を書こう。
tut.lesson-10.14	その間に、陶器の壺をもっと調達してきた方がいい。この事業が販売用の商品を生産できるようにするためにね。\n誰が売っているかはわからないから、自分で車で回って見つけるしかないな。
tut.lesson-11.title	オーバーレイとレポート
tut.lesson-11.1	それでは、様々な場面で役立つ情報オーバーレイとレポートをご紹介します。
tut.lesson-11.2	左上には、追加情報を表示するさまざまなドロップダウンが表示されます。\n最初の1枚をクリックします。
tut.lesson-11.3	こちらは資源表示画面です。特定の資源を売買している人を確認できます。\n「陶器の壺」までスクロールして、それをクリックしてみてください。誰がその資源を取引しているかがわかります。他の資源についても確認できます。\nこのオーバーレイを素早く表示するには、<b>Z</b>キーを押すことで表示できます。
tut.lesson-11.4	また、複数のリソースを選択し、左のハイライトボタンを押すことで、選択したリソースをお気に入りとして登録することができます。お気に入り登録された資料は、このオーバーレイを開いたときに記憶されます。\nそして、右のハイライトボタンを押すことで、お気に入りを切り替えることができます。\n自由に試してみてください。終わったら、同じように左上のボタンでオーバーレイを閉じて、次に進みます。
tut.lesson-11.5	その隣には、情報オーバーレイのリストがあります。クリックすると開きます。
tut.lesson-11.6	このように、いくつものオーバーレイがありますが、ここではそのいくつかに絞って説明します。
tut.lesson-11.7	<b>リスペクト</b>オーバーレイは、あなたの近所でのリスペクトの度合いを示しています。\nテリトリーは、各ブロックのリスペクトの高さに応じて広がっていくので、リスペクトの高さを維持しながら育てていくことが重要です。その方法については、後ほど説明します。\nまた、<b>C</b>キーを押すことで、このレポートを素早く表示させることができます。\n自由に探索し、準備ができたら「続行」をクリックしてください。
tut.lesson-11.8	<b>ヒート</b>オーバーレイも非常に重要です。これは、違法行為や喧嘩などによる、各コーナーでの警察の注目度を示しています。\nヒートが高ければ高いほど、警察が突然やってくる可能性は高くなります。\nまた、このレポートは<b>X</b>を押すことですぐに表示させることができます。\n準備ができたら「続行」をクリックしてください。
tut.lesson-11.9	<b>警察管区</b> のオーバーレイは、どのコーナーがどの管区に属しているかを示しています。\n各署に一人、地域を巡回している隊長がいるので、その人と仲良くなるのもいいかもしれませんね。\n準備ができたら「続行」をクリックします。
tut.lesson-11.10	下部には、<b>ゾーニング</b>のオーバーレイがあり、都市のゾーニング規制が表示されます。\n一般的にビジネスは工業地域や商業地域に限定されていますが、住宅地域にも独自のサプライズがあるかもしれません。\n準備ができたら「続行」をクリックします。
tut.lesson-11.11	その下の<b>人口</b>のオーバーレイは、都市におけるさまざまな民族の分布を表しています。\n同じ民族の人たちは、平均より少し好感を持つ傾向があるので、それを利用する。\n準備ができたら「続行」をクリックします。
tut.lesson-11.12	さて、3つ目のドロップダウンは、レポートのコレクションです。そのボタンを押して開いてください。
tut.lesson-11.13	このドロップダウンには、ゲームのさまざまな部分に関連する、参照可能なレポートがリストアップされています。\n決算報告書が一番わかりやすいと思いますが、他の報告書もとても役に立ちます。\n確認後「続行」をクリックしてください。
tut.lesson-11.14	最後に4つ目のボタンは、ゲームに関するさまざまな情報をまとめた「禁酒法百科事典」を表示します。
tut.lesson-11.15	ゲームの要素でわからないことがあったら、まずここで確認してください。\n確認後「続行」をクリックしてください。
tut.lesson-11.16	では、物資の調達に戻りましょう。\n後ほど、テリトリーについてお話したいと思います。構成員とテリトリーを増やすことは、利益を最大化するためにも、ライバルから身を守るためにも、とても重要です。
tut.lesson-11.17	ああ、ライバルについて言ったかな？\nまだライバルに遭遇していないなら、心配しなくていい。そのうち出会うだろう。でも、その話は後でしよう。\n今は、ビールの生産を始めることに集中してくれ！ 画面左上の目標を確認して、陶器の壺をもっと買って、安全な隠れ家に届けてくれ。\nちなみに、車で移動中に誰かを訪問する時、通常の<b>左クリック</b>ではなく、<b>Shift+左クリック</b>を使うと、他の話題を飛ばして、すぐに売買の会話に入れるぞ。
tut.lesson-12.title	フロントとテリトリー
tut.lesson-12.1	もうひとつ重要なこと、<b>テリトリー</b>について説明しましょう。\n街角のコントロールは、成功するため基礎となるものです。\nテリトリーを支配下に置いてからでないと、事業を増やしたり、構成員を雇ったりすることはできません。
tut.lesson-12.2	今あなたのコントロール下にあるのは、隠れ家がある一角だけです。\n私の計算では、人を雇い、組織を大きくするためには5~6人は必要でしょう。
tut.lesson-12.3	コーナーのコントロールは、リスペクトから生まれます。あなたのことを知れば知るほど、あなたのリスペクト度は上がり、それが100に近づくと、コーナーはあなたに忠誠を誓うようになります。
tut.lesson-12.4	テリトリーは多くの利益をもたらします。まず、より多くの地域を押さえれば、それだけ多くの人を雇い、建物を支配することができます。\n次に、テリトリー内のビジネスはあらゆるチャンスを提供してくれるので、可能な限り拡大することが重要です。\n最後に、これは言うべきではないかもしれませんが、テリトリー内のビジネスから現金をゆすり取ることができます。残酷な行為ではありますが、安定した収入源にはなるんです。ただし、その結果として何かしらの報いがあるかもしれません。
tut.lesson-12.5	そのためには、<b>フロント</b>を設定する必要があります。\nフロントとは、地域の足場を固めるために、まず一角を押さえ、その力で周囲を巻き込んでいく方法です。\nその方法をお教えします。
tut.lesson-12.6.m	いとこの{name}を訪ねて、あなたのためにフロントを張ることに興味があるかどうか聞いてきてください。
tut.lesson-12.6.f	いとこの{name}を訪ねて、あなたのためにフロントを張ることに興味があるかどうか聞いてきてください。
tut.lesson-12.7	この会話では、まず<sprite name="ui tickets">恩義ステップから始まり、<sprite name="ui tribute">フロントスタートについて質問しています。\n会話を終え、必要な現金と<sprite name="ui tickets">恩義を払ってフロントを依頼します。
tut.lesson-12.8	素晴らしい！新しいフロントが組まれたな。このコーナーがすぐに自分のテリトリーに加わったのが解るだろう！
tut.lesson-12.9	フロントは、自分のテリトリーを拡大するため、近隣からのリスペクトを集めるために使われます。また、ビジネスへの強要の場合は、彼らが現金を回収してくれる。
tut.lesson-12.10	さて、新しいフロントには、もっともっと領地を大きくできるようにリスペクトを高める努力をしてもらおう。
tut.lesson-12.11.m	いとこの{name}に戻って、今回は<sprite name="ui pip front expansion ready">あなたのテリトリーを拡大することについて彼に尋ねてみよう。\n彼が要求する金額に同意できれば、作業を開始してくれる。
tut.lesson-12.11.f	いとこの{name}に戻って、今回は<sprite name="ui pip front expansion ready">あなたのテリトリーを拡大することについて彼女に尋ねてみよう。\n彼女が要求する金額に同意できれば、作業を開始してくれる。
tut.lesson-12.12	よし、{name}は、近所での知名度アップを進めてくれている。\n7~8ターンすれば、そのコーナーがあなたを認識し、あなたのテリトリーに入るはずです。\nそれまで一緒に待っていよう。
tut.lesson-12.13	<i>(新しいコーナーがプレイヤーの領地に加わるのを待ちます。数ターンで完了するはずです。その間、あなたは自分の仕事をすることができます。)</i>
tut.lesson-12.14	これを見てくれよ！これで3つのコーナーを制圧したことになる。なかなか良いじゃないか。
tut.lesson-12.15	さて、ここで覚えておいてほしいことがあります。フロントがあなたの代わりに働いてくれるなら、それなりのコストがかかります。少なくとも月に一度は訪問し、その費用を負担するようにしてください（支払いが滞っている場合は、<sprite name="ui pip front needs"> または <sprite name="ui pip front needs urgent"> というサポートアイコンが表示されます）。\nあるいはその地域のビジネスを買収する方法もある。そうすればフロントは代金を回収し、経費として上前をはねた上で残りを現金で渡してくれる。\nこれについては、また後ほど。
tut.lesson-12.16	今度は、合計5つのコーナーになるまで広げ続けます。\nまた{name}に戻って、何度も現金を払ってコーナーを増やしてください。\nまた、別のフロントを立ち上げることもできますが、既存のフロントを中心に展開した方が長期的にはコスト的に有利になります。\n画面左のミッションリストにメモしておきます。
tut.lesson-13.title	ゆすり
tut.lesson-13.1	ゆすりのことを言ったんだよな？\n まあ、正直に言うと、俺はそんなことやったことないんだ。俺はどちらかと言えば優しすぎる人間だから、誰も俺を怖がったりはしない。\nでも、地元の店に行くと、ゴロツキどもが何人かいてさ、いかにも強面のやつらが、周りのビジネスに '保護' を提供してどれだけ稼いでるかを自慢してるんだ。\nどうやってやってるのか、教えてやるよ。
tut.lesson-13.2	まず、脆弱性のあるビジネスを特定します。例えば、このようなものです。\n自分のテリトリーであり、かつ<i>フロントに近い場所でなければならない。</i> そうでなければ、彼らはあなたを恐れないでしょう。
tut.lesson-13.3	そして、車でそこに行き、<sprite name="ui pip front extortion">保護について会話をするのです。笑顔で、でも親しげに、ね。\nすぐに理解されますよ。そして何人かはすぐに降参するでしょう、特にあなたを本当に尊敬している人たちはね。\nしかし、そうでなければ、新たな問題を抱えることになり、何か手を打たなければ、軽蔑の念を抱かれることになります。
tut.lesson-13.4	いずれにせよ、強要は厄介なビジネスであることを忘れてはならない。相手が不幸になるし、そのことで他人に文句を言われる。\n人を傷つけるようなことをするとそれが噂になり、人間関係が悪くなるかもしれません。逆にあなたが人に良いことをすれば、その人はそのことを話題にし、他の人に影響を与えるでしょう。
tut.lesson-13.5	試してみたくてウズウズしているようですね。ビジネスに乗り込んでいって、<sprite name="ui pip front extortion">不幸から守ることを話してみて、何が起こるか見てみましょう。私はここで待っています。
tut.lesson-13.6	<i>(新しく獲得したテリトリーで、<sprite name="ui pip front extortion">うまくビジネスを強要するのを待っています。)</i>
tut.lesson-13.7.m	結果的に、あなたは金儲けのために無実の人を脅し、傷つけた。\n可哀想なお母さんは、自分の坊やがどうなったか知らなくて良かったと思うよ。
tut.lesson-13.7.f	結果的に、あなたは金儲けのために無実の人を脅し、傷つけた。\n可哀想なお母さんは、自分の娘がどうなったか知らなくて良かったと思うよ。
tut.lesson-13.8	でも、これはそういうものなんです。あなたがゆすり取る人々は毎月最寄りのフロントに小さな封筒を持っていきます。フロントはそれを全て回収し、運営経費を差し引き、残りをいつでも受け取れるように用意してくれます。\nただ、定期的にフロントを訪問してお金を受け取ったり、必要であれば費用を負担することを忘れないでください。もし、フロントが倒産してしまったら、それまでに築いたテリトリーをすべて失うことになります。
tut.lesson-13.9	今度は自分のテリトリーを増やしていき、合計で5つのコーナーを持つようにします。\nまず、自分のフロントのオーナーが<sprite name="ui pip front needs">サポートや<sprite name="ui pip front needs urgent">緊急サポートを必要としている場合、助けにいきましょう。\n次に、フロントのオーナーに相談して、<sprite name="ui pip front expansion ready">コーナーを拡大する準備を進めることです。\nそして、5コーナーまではまだ時間がかかりそうなので、引き続き自家製ビールを製造・販売し、さらなる紹介を得ましょう、期待しています。ではまた。
tut.lesson-14.title	採用
tut.lesson-14.1	そして、テリトリーが広くなったところで、もう一人構成員を増やそうかと考えています。\n構成員の数が多ければ多いほど、1ターンにできることが増えます。例えば、配達を担当させながら、自分が重要な仕事をすることも可能です。
tut.lesson-14.2	また、構成員の人数が多ければ、ライバルから身を守ることもできます。一旦、敵に遭遇してしまえば、その時はその時です。
tut.lesson-14.3	より多くの構成員を雇うには、マーカーに<sprite name="ui pip social crew"> 雇い人のアイコンがあるオーナーを探せばよいでしょう。彼らは興味のある人を知っています。\nその人のことをもっと知るためには、車で移動して話を聞く必要があります。
tut.lesson-14.4	候補者と話しながら、その人の性格的な特徴を探ってください。仕事によっては、とても重要なことです。\n候補者と話しながら、その人の性格的な特徴を探ってください。例えば、管理職には無頓着な人を、筋肉マンには弱い人を採用したくないでしょう。\n(構成員になりそうな人のリストを見るには、<sprite name="ui info"> レポートダイアログを開き、<sprite name="ui crew list"> 構成員リストを見ることもできます。)
tut.lesson-14.5	さあ、誰かを雇ってみてください。待っているよ。
tut.lesson-14.6	<i>(2人目の構成員を雇うのを待っています。)</i>
tut.lesson-14.7	よし！構成員の人数が2倍になったぞ！\n右側のリストに新しい構成員が表示されます。
tut.lesson-14.8	通常のゲームでは、この新しい構成員のために新しい車両を購入する必要があります。\nしかし、このチュートリアルでは、古いトラックを手に入れたので、それを利用することができます。\nあなたの隠れ家の前に置いてきたので、この車両を新しい構成員に割り当ててみてくれ、どうすればいいか分かると信じてる。
tut.lesson-14.9	<i>(新入りへの車両割り当てを待っています。)</i>
tut.lesson-14.10	やったな！これで新しい構成員は活躍の場が広がりました。\n手動で指示したい場合は、リスト内のカードをクリックし、行き先や行動を指示すればよいのです。あなたができることは、すべて彼らにもできるのです。\nまた、特定の<b>配送ルート</b>を割り当てれば、特定の配送スケジュールに従って配送することも可能です。\nすぐに設定してみましょう。
tut.lesson-14.11	左側のミッションが完了したら、隠れ家にいる私を訪ねてくれ。\nまた何かを用意しておくよ。
tut.lesson-15.title	配達
tut.lesson-15.1	2人目の構成員ができたので、仕事の一部を任せることができるようになりました。 商品の売り込み、材料の買い付け、フロントへの訪問などです。\nさあ、やってみましょう。新入社員は、喉が渇いたお客さんに自家製ビールを届けるための基本的な配達ルートを数ステップで走らせることができます。\n右側の<b>配達</b>のボタンをクリックすると開始されます。
tut.lesson-15.2	まず、この配達を実行する人を割り当てる必要があります。 <b> + </b>ボタンをクリックします。
tut.lesson-15.3	ここで<b>ドライバーの割り当て</b>を選択し、新しいトラックと構成員をこのルートに乗せます。自分自身を追加しないように注意してください。お酒の配達よりも大事なことがあるはずです。
tut.lesson-15.4	素晴らしい！では、配送スケジュールを作成します。これは運転手が金庫からビールを受け取って、あちこちに売りに行くという手順書です。\n現在、スケジュールは空ですので、<b>次のステップを追加する</b>をクリックします。
tut.lesson-15.5	納品ステップでは、何をするのか、どこに行くのかを指定する必要があります。まずは倉庫にある自家製ビールを受け取ってもらうところから始めます。\nそこでまず、最初のステップを<b>在庫から荷積み</b> に変更します。
tut.lesson-15.6	このアクションは隠れ家で行われますが、どのリソースをピックアップする必要があるかを選択する必要があります。\nリストから<b>自家製ビール</b>を選択します。
tut.lesson-15.7	この時点で、車両に転送する量を正確に指定できます。 現在の選択は<b>全部</b>です。これは、可能な限り多くのことを行うことを意味します。これはまさに私たちが望んでいることです。\n他の可能性は、特定の量（<b>数量</b>）を選択するか、ストレージに一定量が残っていることを確認して残りを取得する（<b>すべてを除く</b>）、または 車両に一定量が含まれるまで（<b>まで</b>）、物を車両に移動します。\nとりあえず、自家製ビールをトラックに積んでもらおうということで、<b>全部</b>のままにしています。\n数量を選択したので、下の左端のボタンをクリックして、<b><sprite name="ui save step"> このステップを保存して、配送スケジュールに戻る</b>をクリックします。
tut.lesson-15.8	自家製ビールを買うように言ったので、販売を開始するように言う必要があります。 強調表示された<b>次のステップを追加</b>ボタンをもう一度クリックすると、商品をどこに置くかが決まります。
tut.lesson-15.9	アクションを<b>材料の売却</b>に変更し、リソースのリストから<b>自家製ビール</b>を選択します。\n目的地のリストも変更され、自家製ビールを購入することを知っているすべての企業が含まれます。 繰り返しになりますが、現在購入する最大数（<b>全部</b>）を販売するか、試して販売する数量（<b>数量</b>）を選択するかを選択できます。 今のところ、私たちは彼らが取る限りそれらを売ろうとします。\nうまくいったら、真ん中の<b><sprite name="ui save add new"> 保存して新しいステップを追加</b> というボタンをクリックします。 - このステップを保存して、すぐに複製を作成します。
tut.lesson-15.10	"では、その様子をご覧ください - "保存して追加"をクリックすると、前のステップと同じ設定の新しいステップができました。もちろん、同じ企業に再び販売することはないので、販売先を変更しましょう。\n地図上には、あなたの自家製ビールを買い取りたいお店が表示されています。その中から好きなお店を選んでクリックするだけで、新しい目的地に行くことができます。\nさあ、試してみてください！ これは配達に多くのステップを簡単に追加し、ドライバーが賢明なルートをたどっていることを確認するための優れた方法です。 完了したら、<b> <sprite name="ui save add new">保存して新しいステップを追加</b>ボタンをクリックします。"
tut.lesson-15.11	ドライバーはビールを売った後、多額の現金を手にすることになりますが、それを持ったまま運転されるのは困るでしょう。そこで、現金を隠れ家に置いてくるステップを追加しましょう。\n作成した新しいステップで、アクションを<b>在庫に荷降ろし</b>に変更してから、リソースを<b>現金</b>に変更します。\n左端の<b><sprite name="ui save step"> 保存して戻る</b>をクリックすると、ステップが保存され、経路の概要に戻ることができます。
tut.lesson-15.12	シンプルな配送ルートだ！ 次に<b> <sprite name="ui start job">この配達を開始</b>を押すとすぐに、次のターンにジョブが開始され、指示に従います。\n次に、ドライバーがリストの最後のステップに到達すると、ドライバーは最初からやり直し、停止するように指示するまでこれを続けます。 ドライバーは割り当てられたタスクを実行するときに移動ポイントとアクションポイントを使い果たすことを忘れないでください。そのため、仕事に適した人を選択し、経験のアップグレードを賢く使用するようにしてください。\nでは、<b><sprite name="ui start job">この配達を開始</b>をクリックして、スタートします。
tut.lesson-15.13	その他、配送ルートについて少しお話させてください。\nルート名をクリックすると、ルート名を変更することができます。これで管理しやすくなるかもしれませんね。\nステップ番号をクリックして位置を変更したり、上下の矢印をクリックすることで、配信ステップの順番を変更することができます。\n最後に、<sprite name="ui mute step">でステップの有効/無効を切り替えたり、<sprite name="ui start here">で次のターンで特定のステップに強制的に移動させることができます。
tut.lesson-15.14	さて、クルーメンバーのために配送の仕事を整理する基本は掴んだと思う。自家製ビールを販売する準備は整ったが、もっと他のことも頼めるんだ。例えば、ビールを作るために必要な資源を調達してくることもできる。\nだから、陶器の壺を買うステップをいくつか追加してみよう。まず、少し現金を受け取るステップを追加してから、陶器の壺を買える店に2〜3回立ち寄り、最後にそれらを隠れ家に届けるステップを追加するんだ。
tut.lesson-15.15	それができれば、自家製ビールの製造も順調に進むだろう。街を散策したり、新しい人と出会ったり、ミッションをこなしたり、スキルを身につけたり、テリトリーを広げたり…ボスがやるべきことはたくさんあるだろう。
tut.lesson-16.title	卒業
tut.lesson-16.1.m	親愛なる甥よ、最後に忠告しておこう。
tut.lesson-16.1.f	親愛なる姪よ、最後に忠告しておきたいことがある。
tut.lesson-16.2	まず、建物を増築するべきだ。そうすれば拠点が大幅に増える。\n<sprite name="ui pip social expansion"> 建物拡大アイコン、彼らは積極的に機会を探している人々を探しましょう。\n備忘録として、あなたのリストに新しいミッションを追加しておくよ。
tut.lesson-16.3	次に、テリトリーと人脈の両方を<b>拡大</b>し続けるんだ。\nチャンスはたくさんあるだろうが、それは自分の名前を知られた人にしか訪れない。
tut.lesson-16.4	第三に、あなたが知らないことがまだたくさんあるだろう。 人と話すときは、新しい<b>スキル</b>を学び、まだ調べていない<b>リソース</b>についてもっと調べてみてくれ。 いくつかは本当に有益な可能性があるだろう。
tut.lesson-16.5	四つ目は、<b>競争</b>を期待することだ。そのうち、警官やごろつきや他の人たちと出会うことになるでしょう。その時はまたアドバイスします。
tut.lesson-16.6	最後に、<b>財務</b>に目を配ることだ。お金は商売の歯車の潤滑油と言われるように、もしお金が足りなくなったら、このビジネス全体が止まってしまうだろう。
tut.lesson-16.7	こんなに早く成功するとは思わなかったよ、がんばってな。\nまた、必要であればアドバイスするけど、それまでは自分で頑張ってみてくれ。\n大都会を楽しんで！\n\n<i>(これでメインのチュートリアルがオフになります。メインメニューの設定からオンに戻すことができます。)</i>
tut.event.title	ゲームプレイヒント
tut.event.movementpts	<sprite name="ui movement pts"> 移動ポイントが無くなったんですね。 各ターンの開始時に回復します。画面上部の<b>次のターン</b> を押すと次のターンに進みます。
tut.event.actionpts	<sprite name="ui action pts"> アクションポイントが無くなったんですね。  各ターンの開始時に回復します。画面上部の<b>次のターン</b> を押すと次のターンに進みます。
tut.event.goon	{groupname}に会いましたね！\n彼らは、街のあちこちにいる小さなトラブルメーカーだ。組織とは違い一角を占拠しているため、独占欲が強い反面、野心も乏しい。\n仲が良ければ、違法な商品を分けてくれたり、別の方法で助けてくれたりするかもしれません。しかし、もし喧嘩をしたいのなら、ただ会話をして、相手を侮辱し、何が起こるか見てみることだ。
tut.event.gang	{groupname}に会いましたね！\nこれは他の組織的な団体の1つです。あなたと同じように、禁酒法から利益を得ることに関心があり、資源や顧客をめぐってあなたと競争する可能性があります。\n平和的にアプローチするもよし、そうでない場合もよし、それはあなた次第です。ただ、相手に対して自分がどれだけ強いか、そして侮辱や怪我はすぐには忘れられないということは覚えておいてください。
tut.event.cop	{groupname}に会いましたね！\n警察官は、ヒートが高いコーナーに突撃したり、地区を巡回して不良を捕まえたりします。\nそのためには、共通の友人から推薦された署員と仲良くなり、その署員を買収して、あなたの活動を無視するように仕向けることも有効でしょう。
tut.event.prod.complete	あるビジネスの生産サイクルが終了しました。生産された製品は、あなたの建物の倉庫に保管されています。
tut.event.prod.stalled	あるビジネスが停滞している。これは多くの場合、原料の不足が原因です。自分のビジネスをチェックして、必要な材料がすべて揃っていることを確認しましょう。
tut.event.levelup	構成員が新しいレベルに到達しました！\n<sprite name="xp general">経験値テロップをクリックすると、新しい能力を選ぶことができます。
tut.event.outpost-can-expand	あなたのフロントの1人は、あなたのテリトリーをさらに拡大する準備ができている。\nあなたのフロントを訪問し、新しいコーナーでリスペクトを高めるために彼らにお金を払おう。リスペクトは多いに越したことはない!
tut.event.outpost-urgent	前線のひとつが、緊急にあなたのサポートを必要としています。\n経費をまかなえなくなったフロントは、やがて閉鎖され、テリトリーのコーナーからリスペクトを失い、あなたのシマから出て行ってしまうでしょう\n<sprite name="ui pip front needs urgent">の封筒アイコンがある建物を探して、すぐに訪問してください。
tut.event.vehicle-junk	あなたの愛車の1台が、少しづつ傷んできています。傷ついたクルマは、状態の良いクルマよりも遅く走り、いつかは完全に動かなくなります。\n近くの修理工場に足を運び、車両を良好な状態に保ちましょう。
tut.event.crew-injured	仲間が負傷しました！\n怪我をした構成員も、いくつかの仕事はできますが、ある程度しかできません。\nできるだけ早く自分の建物に戻し、右上の構成員情報カードにある<sprite name="ui health"> 回復ボタンをクリックして<b>回復</b>させてください。
tut.event.gambling	ギャンブルする場所を作ることができそうです！\nフロントに相談し、オーナーに近隣のコーナーでギャンブルハウスを建設するための住宅用建物を探してもらいましょう。\nその後、現金や現物で報酬を得ることができる様々なタイプのゲームを設置することができます。
info.jewelry.icon	<sprite name="res jewelry">
info.jewelry.name	宝石
info.jewelry.desc	何千年もの間、輝き、カットされ、磨かれたクリスタルは常に高価なものでした。単独ではそれほど実用的ではないかもしれませんが、裕福な人々はこれを集めることが大好きで、買い求めます。もし鉱物の幸運に恵まれたなら、高値で売りさばける可能性があります。\n\n<indent=10><b>基本価格 <sprite name="ui buy"> 通常の商売では売買不可</b></indent>\n\n<i><indent=30><i>...磨かれた銀や彫刻された金、結婚指輪や愛の高価な飾り物が宝石店の窓に輝いているのを見ると、心地よく目が眩む。</i></indent>\n <indent=40>—ナサニエル・ホーソーン</indent>
info.homemade-brandy.icon	<sprite name="res homemade-brandy">
info.homemade-brandy.name	自家製ブランデー
info.homemade-brandy.desc	<b>地域限定の製品で、すべての都市で利用可能ではありません。</b>\n\n果物、水、熱さえ手に入れば、家庭で簡単に作れる美味しくさわやかなブランデーはすぐそこです。<link="production-homemade-brandy">自家製ブランデー事業</link>でブランデーを手に入れることができます。\n\n<indent=15><b>基本価格 <sprite name="ui sell"> 1ケースあたり $18</b></indent>\n\n<i><indent=30><i>見事な果実をたわわに実らせた木々は、目を惹きつけ、突然の欲望をかきたて、手を伸ばし、摘み取りたい衝動に駆られた。</i></indent>\n <indent=40>—ジョン・ミルトン</indent>
info.production-homemade-brandy.name	自家製ブランデー蒸留器
info.production-homemade-brandy.desc	<b>地域限定の事業で、すべての都市で利用可能ではありません。</b>\n\n<indent=10>果物または柑橘類、小さな樽、壺を使って自家製ブランデーを作ります。 <b><sprite name="res fruit"> + <sprite name="res half-barrel"> + <sprite name="res jugs"> <sprite name="ui arr sm right"> <sprite name="res homemade-brandy"> <sprite name="res citrus"> + <sprite name="res half-barrel"> + <sprite name="res jugs"> <sprite name="ui arr sm right"> <sprite name="res homemade-brandy"></b>\n\n<b>必要条件:</b> <sprite name="ui skills"><link="homemade-brandy-making">自家製ブランデー製造</link>、<sprite name="res cash"> 1000、<sprite name="res steel-barrels"> 10、<sprite name="res bricks"> 4</indent>\n\nこの事業を設置し、<link="fruit-other">果物</link>や<link="citrus">柑橘類</link>、<link="half-barrel">小さな樽</link>、<link="crocks">陶器の壺</link>を供給すると、<link="homemade-brandy">自家製ブランデー</link>を生産します。これを都市中のビジネスに販売したり、自分の街角のスピークイージーで売ることができます。
info.homemade-brandy-making.icon	<sprite name="ui skills">
info.homemade-brandy-making.name	自家製ブランデーの製造
info.homemade-brandy-making.desc	このスキルを習得すると、あなたの組織が管理する建物に <link="production-homemade-brandy">自家製ブランデー蒸留所</link> を<b>建設</b>できるようになります。このスキルを習得すると、<sprite name="res jugs"><link="crocks">陶器の壺</link>や<sprite name="res half-barrel"><link="half-barrel">小さな樽</link>を使用して、<sprite name="res fruit"><link="fruit-other">果物</link>や<sprite name="res citrus"><link="citrus">柑橘類</link>を<sprite name="res homemade-brandy"><link="homemade-brandy">自家製ブランデー</link>に変換することが可能になります。\n\n<i><indent=30><i>美しい果実で満ちた木々は目を引き、誘惑し、私の食欲を突如かき立てた。</i></indent> \n<indent=40>—ジョン・ミルトン</indent>
info.amaretto.icon	"<sprite name="res amaretto">"
info.amaretto.name	Amaretto
info.amaretto.desc	"<b>地域限定の製品で、すべての都市で利用できるわけではありません。</b>\n<sprite name="res nuts"><link="nuts">ナッツ</link>と<sprite name="res sugar"><link="sugar">砂糖</link>から作られるこの甘いリキュールは、ほのかな苦味を保ち、カクテルの材料として非常に人気があります。<link="amaretto-still">アマレット蒸留所</link>で製造されます。\n\n<indent=15><b>基本価格\n<sprite name="ui sell"> 1ケースあたり $32</b></indent>\n\n<i><indent=30>「この国の最高のものを少し持っていきなさい......バルサムや蜂蜜、いくつかの香料と没薬、ピスタチオナッツとアーモンドを贈り物として。」</i></indent>\n<indent=40>—創世記</indent>"
info.nuts.icon	"<sprite name="res nuts">"
info.nuts.name	ナッツ
info.nuts.desc	"<b>地域限定の製品で、すべての都市で利用可能ではありません。</b>\n\nナッツは、たんぱく質と糖分が豊富に含まれており、栄養価が高いです。さらに、<sprite name="res sugar"> <link="sugar">砂糖</link>の量を増やして<link="amaretto-still">アマレット蒸留所</link>で加工すれば、非常に人気のある<sprite name="res amaretto"> <link="amaretto">アマレット</link>を作ることができます。\n\n<indent=15><b>基本価格 <sprite name="ui buy"> 1袋あたり $12</b></indent>\n\n<i><indent=30><i>この地の最良の産物を贈り物として持っていきなさい……少しのバルサムと蜂蜜、香料と没薬、ピスタチオナッツとアーモンド。</i></indent> \n<indent=40>—創世記</indent>"
info.absinthe.icon	"<sprite name="res absinthe">"
info.absinthe.name	アブサン
info.absinthe.desc	"<b>地域限定の製品で、すべての都市で利用可能ではありません。</b>\n\n秘密のセットの<sprite name="res herbs"> <link="herbs">ハーブ</link>を<sprite name="res wheat"> <link="wheat">小麦</link>と一緒に<link="absinthe-still">アブサン蒸留所</link>で加工して作られる伝説的な飲み物。街の芸術家や上流階級は、この新製品を提供する店に群がることでしょう。\n\n<indent=15><b>基本価格 <sprite name="ui sell"> 1ケースあたり $60</b></indent>\n\n<i><indent=30><i>アブサンのグラスと夕焼けの間に、どんな違いがあるというのだろう？</i></indent> \n<indent=40>—オスカー・ワイルド</indent>"
info.herbs.icon	"<sprite name="res herbs">"
info.herbs.name	ハーブ
info.herbs.desc	"<b>地域限定の製品で、すべての都市で利用可能ではありません。</b>\n\nハーブは、その薬効と食べ物や飲み物に独特で繊細な風味を与える力から、古くから魔法の植物として使われてきました。特に、<link="absinthe-still">アブサン蒸留所</link>で<sprite name="res absinthe"> <link="absinthe">アブサン</link>を作る際に役立ちます。\n\n<indent=15><b>基本価格 <sprite name="ui buy"> 1箱あたり $10</b></indent>\n\n<i><indent=30><i>ハーブは医師の友であり、料理人の誇りである。</i></indent> \n<indent=40>—シャルルマーニュ</indent>"
info.nalewka.icon	"<sprite name="res nalewka">"
info.nalewka.name	ナレフカ
info.nalewka.desc	"<b>特定の製品はポーランドの組織でのみ製造可能です。</b>\n<i>ポーランド組織コンテンツパックが必要です。</i>\n\nハーブや果物、ベリーを使用して、通常のウォッカに独特な風味を加えます。これは特別な<link="nalewka-production">ナレウカ製造</link>事業で作られます。"
info.german-lager.icon	"<sprite name="res lager">"
info.german-lager.name	ドイツラガー
info.german-lager.desc	"<b>ドイツ系組織のみが製造可能な特別製品。</b>\n<i>ドイツ系組織コンテンツパックが必要です。</i>\n\n密造ビールを長期間低温で冷却すると、より澄んだ、爽やかなラガービールが完成します。これは特別な<link="lager-production">ドイツラガー製造事業</link>で製造されます。"
info.grappa.icon	"<sprite name="res grappa">"
info.grappa.name	グラッパ
info.grappa.desc	"<b>イタリア系組織のみが製造可能な特別製品。</b>\n<i>イタリア系組織コンテンツパックが必要です。</i>\n\nワインの製造過程で残るブドウの皮やその他の残渣を、熱を使って蒸留すると、さらにイタリアの伝統的なアルコールが作られます。これは特別な<link="grappa-production">グラッパ製造事業</link>で製造されます。"
info.blended-whisky.icon	"<sprite name="res blended-whisky">"
info.blended-whisky.name	ブレンデッドウイスキー
info.blended-whisky.desc	"<b>アイルランド系組織のみが製造可能な特別製品。</b>\n<i>アイルランド系組織コンテンツパックが必要です。</i>\n\n2種類の異なるウイスキーをブレンドすることで、それぞれの良い要素を引き出したウイスキーを作ります。これは特別な<link="blended-whiskey-production">ブレンデッドウイスキー製造事業</link>で製造されます。"
info.amaretto-still.name	アマレット・スティル
info.amaretto-still.desc	"\n<indent=10>砂糖、ナッツ、ボトルからアマレットを製造します。 <b><sprite name="res nuts"> + <sprite name="res sugar"> + <sprite name="res bottles"> <sprite name="ui arr sm right"> <sprite name="res amaretto"></b>\n\n<b>必要条件:</b> <sprite name="skill amaretto"> <link="amaretto-skill">アマレット蒸留スキル</link> <sprite name="res cat materials"> 建材</indent>\n\nこの事業では、<link="nuts">ナッツ</link>と<link="sugar">砂糖</link>から<link="amaretto">アマレット</link>を製造することができます。"
info.nalewka-production.name	ナレフカ製造
info.nalewka-production.desc	"<indent=10>ウォッカと果物からナレウカを製造します。 \n<b><sprite name="res fruit"> + <sprite name="res vodka-barrel"> <sprite name="ui arr sm right"> <sprite name="res nalewka"> <sprite name="res vodka"> + <sprite name="res fruit"> <sprite name="ui arr sm right"> <sprite name="res nalewka">\n\nポーランド風の内容が含まれる <sprite name="flag-pl"> Polish Outfit Content Packが必要です。</b></indent>\n\nこの事業では、<link="fruit-other">果物</link>と<link="vodka-bottled">ボトルウォッカ</link>または<link="vodka-barrel">樽ウォッカ</link>から<link="nalewka">ナレウカ</link>を製造することができます。"
info.lager-production.name	ドイツラガー生産
info.lager-production.desc	"<indent=10>バックルームビールと氷からドイツラガーを製造します。 <b><sprite name="res fake-beer"> + <sprite name="res ice"> <sprite name="ui arr sm right"> <sprite name="res lager">\n\nドイツ風の内容が含まれる <sprite name="flag-de"> German Outfit Content Packが必要です。</b></indent>\n\nこの事業では、<link="fake-beer">バックルームビール</link>と<link="ice">氷</link>から<link="german-lager">ドイツラガー</link>を製造することができます。"
info.grappa-production.name	グラッパ製造
info.grappa-production.desc	"<indent=10>ブドウ、ボトル、小瓶、ラベル、ガソリンからグラッパと偽ワインを製造します。 <b><sprite name="res grapes"> + <sprite name="res small-bottles"> + <sprite name="res bottles"> + <sprite name="res labels"> + <sprite name="res gasoline"> <sprite name="ui arr sm right"> <sprite name="res grappa"> + <sprite name="res fake-wine">\n\nイタリア風の内容が含まれる <sprite name="flag-it"> Italian Outfit Content Packが必要です。</b></indent>\n\nこの事業では、<link="grappa">グラッパ</link>と<link="fake-wine">偽ワイン</link>を、<link="grapes">ブドウ</link>、<link="bottles">ボトル</link>、<link="small-bottles">小瓶</link>、<link="labels">ラベル</link>、および<link="gasoline">ガソリン</link>から製造することができます。"
info.blended-whiskey-production.name	ブレンデッドウイスキー製造
info.blended-whiskey-production.desc	"<indent=10>モルトシロップ、大麦、ボトル、ウイスキーバレル、ガソリンからブレンデッドウイスキーを製造します。 <b><sprite name="res malt"> + <sprite name="res barley"> + <sprite name="res bottles"> + <sprite name="res whiskey-barrel"> + <sprite name="res gasoline"> <sprite name="ui arr sm right"> <sprite name="res blended-whisky">\n\nアイルランド風の内容が含まれる <sprite name="flag-ir"> Irish Outfit Content Packが必要です。</b></indent>\n\nこの事業では、<link="blended-whisky">ブレンデッドウイスキー</link>を、<link="malt">モルトシロップ</link>、<link="barley">大麦</link>、<link="bottles">ボトル</link>、<link="whiskey-barrel">ウイスキーバレル</link>、および<link="gasoline">ガソリン</link>から製造することができます。"
info.absinthe-still.name	アブサン・スチル
info.absinthe-still.desc	"<indent=10>ハーブと小麦とボトルからアブサンを作る。\n<b><sprite name="res herbs">+ <sprite name="res wheat"> + <sprite name="res bottles"> <sprite name="ui arr sm right"> <sprite name="res absinthe"></b>\n\n<b>必要なもの：</b>\n<sprite name="skill absinthe"> <link="absinthe-skill">アブサン・ワークス</link> <sprite name="res cat materials"> 建築資材</indent>\n\nこれは <link="absinthe">アブサン</link> を <link="herbs">ハーブ</link> と <link="wheat">小麦</link>から製造できる製造所です。"
info.amaretto-skill.icon	"<sprite name="skill amaretto">"
info.amaretto-skill.name	アマレットの蒸留
info.amaretto-skill.desc	"ナッツをスチルで扱うノウハウを持つ人が見つかれば、高級カクテルに需要の高いアマレットを作ることができますよ。アマレットを作るには、<sprite name="res nuts"> <link="nuts">ナッツ</link>	 <sprite name="res sugar"> <link="sugar">砂糖</link> とスペースが必要です。"
info.absinthe-skill.icon	"<sprite name="skill absinthe">"
info.absinthe-skill.name	アブサン・ワークス
info.absinthe-skill.desc	"アブサンの製造に使われるレシピは、長い間守られてきた秘密であり、手に入れるのは難しいかもしれません。しかし、ノウハウを持っている人を説得して教えてもらうことができれば、<sprite name="res herbs"> <link="herbs">ハーブ</link>	 <sprite name="res herbs"> <link="wheat">小麦</link> といくつかのスペースを使って、アブサンを作ることができると思う。"
